橋梁ID,点検年1,BCI1,点検年2,BCI2,
1,1977,100,2001,74.8,24
1,2002,74.9,2004,70.6,2
1,2004,70.6,2006,70.5,2
1,2012,74.2,2014,74.2,2
1,2014,74.2,2016,73.9,2
2,1976,100,2001,74.5,25
2,2001,74.5,2002,74,1
2,2002,74,2004,73.6,2
2,2004,73.6,2006,73.6,2
2,2006,73.6,2008,73.5,2
2,2012,73.9,2014,73.9,2
3,1982,100,2001,94.2,19
3,2001,94.2,2002,75,1
3,2002,75,2004,73.4,2
3,2004,73.4,2006,73.4,2
3,2006,73.4,2008,73.4,2
3,2008,73.4,2010,72.5,2
3,2012,72.7,2014,72.4,2
3,2014,72.4,2016,71.8,2
4,1990,100,2002,75,12
4,2002,75,2004,75,2
4,2004,75,2006,74.9,2
4,2006,74.9,2008,74.8,2
4,2008,74.8,2010,74.6,2
4,2010,74.6,2012,74.5,2
4,2012,74.5,2014,74.5,2
4,2014,74.5,2016,74.5,2
5,1990,100,2002,75,12
5,2002,75,2004,75,2
5,2004,75,2006,74.9,2
5,2006,74.9,2008,74.8,2
5,2008,74.8,2010,74.6,2
5,2010,74.6,2012,74.6,2
5,2012,74.6,2014,74.6,2
5,2014,74.6,2016,74.3,2
6,1991,100,2001,96.7,10
6,2001,96.7,2002,75,1
6,2002,75,2004,74.8,2
6,2004,74.8,2006,74.7,2
6,2006,74.7,2008,74.5,2
6,2008,74.5,2010,73.9,2
6,2012,74.1,2014,74.1,2
6,2014,74.1,2016,74,2
7,1976,100,2002,74.9,26
7,2002,74.9,2004,66.1,2
7,2004,66.1,2006,65.9,2
7,2006,65.9,2008,63.9,2
7,2010,64.4,2012,63.8,2
7,2012,63.8,2014,63.4,2
8,1976,100,2001,74.9,25
8,2001,74.9,2002,74.9,1
8,2002,74.9,2004,74.9,2
8,2004,74.9,2006,66.4,2
8,2006,66.4,2008,66.4,2
8,2008,66.4,2010,65.7,2
8,2010,65.7,2012,64.6,2
8,2012,64.6,2014,64.1,2
9,2007,100,2008,99.9,1
9,2008,99.9,2010,99.5,2
9,2010,99.5,2012,98.1,2
9,2012,98.1,2014,96.4,2
9,2014,96.4,2016,95.7,2
10,1986,100,2001,98.1,15
10,2001,98.1,2003,83.5,2
10,2003,83.5,2005,81.4,2
10,2005,81.4,2006,78.3,1
10,2006,78.3,2007,77.8,1
10,2009,80.7,2011,79.5,2
10,2011,79.5,2013,76.3,2
10,2013,76.3,2015,75.7,2
10,2015,75.7,2017,74.8,2
11,1930,100,2001,75,71
11,2001,75,2003,74.9,2
11,2003,74.9,2005,72.5,2
11,2005,72.5,2006,72.5,1
11,2006,72.5,2007,71.8,1
11,2007,71.8,2009,61.4,2
11,2009,61.4,2011,60.4,2
11,2013,74.5,2015,74.2,2
11,2015,74.2,2017,73.3,2
12,1978,100,2001,75,23
12,2001,75,2003,75,2
12,2003,75,2005,75,2
12,2005,75,2006,75,1
12,2006,75,2007,75,1
12,2007,75,2009,75,2
12,2009,75,2011,75,2
12,2013,75.1,2015,75.1,2
12,2015,75.1,2017,75,2
13,1971,100,2001,100,30
13,2001,100,2003,73.6,2
13,2003,73.6,2005,73.6,2
13,2006,74.3,2007,72.9,1
13,2009,74.3,2011,73.8,2
13,2011,73.8,2013,73.1,2
13,2013,73.1,2015,71.9,2
13,2015,71.9,2017,71.3,2
14,1971,100,2001,100,30
14,2001,100,2003,74.9,2
14,2003,74.9,2005,74.9,2
14,2005,74.9,2006,74.6,1
14,2006,74.6,2007,74.6,1
14,2007,74.6,2009,74.4,2
14,2009,74.4,2011,73.6,2
14,2011,73.6,2013,73.6,2
14,2013,73.6,2015,73.1,2
14,2015,73.1,2017,72.9,2
15,1971,100,2001,96.9,30
15,2001,96.9,2003,73.5,2
15,2003,73.5,2005,73.5,2
15,2006,74.1,2007,74.1,1
15,2007,74.1,2009,74.1,2
15,2011,74.2,2013,74,2
15,2013,74,2015,73.3,2
15,2015,73.3,2017,72.9,2
16,1970,100,2001,97.4,31
16,2001,97.4,2003,75,2
16,2003,75,2005,75,2
16,2005,75,2006,71,1
16,2006,71,2007,71,1
16,2007,71,2009,69,2
16,2009,69,2011,69,2
16,2011,69,2013,68.6,2
16,2013,68.6,2015,68.6,2
16,2015,68.6,2017,68.2,2
17,1970,100,2001,99,31
17,2001,99,2003,60.6,2
17,2003,60.6,2005,56.5,2
17,2005,56.5,2006,56.5,1
17,2006,56.5,2007,56.5,1
17,2009,67.2,2011,66,2
17,2011,66,2013,65.4,2
17,2013,65.4,2015,64.7,2
17,2015,64.7,2017,64.7,2
18,2001,58.8,2003,58.5,2
18,2005,100,2006,99.9,1
18,2006,99.9,2007,99.9,1
18,2007,99.9,2009,99.9,2
18,2009,99.9,2011,97.2,2
18,2011,97.2,2013,96,2
18,2013,96,2015,95.5,2
18,2015,95.5,2017,85.4,2
19,1993,100,2001,65.7,8
19,2001,65.7,2003,65.5,2
19,2003,65.5,2005,60.3,2
19,2006,60.5,2007,56.2,1
19,2007,56.2,2009,56.2,2
19,2009,56.2,2011,52.8,2
19,2011,52.8,2013,51.5,2
19,2013,51.5,2015,49.5,2
19,2015,49.5,2017,49.4,2
20,1970,100,2001,74.1,31
20,2001,74.1,2003,73.8,2
20,2003,73.8,2005,73.8,2
20,2006,74,2007,73.3,1
20,2009,73.4,2011,72.7,2
20,2011,72.7,2013,72.2,2
20,2013,72.2,2015,72,2
20,2015,72,2017,71.6,2
21,2003,100,2005,100,2
21,2005,100,2006,100,1
21,2006,100,2007,100,1
21,2007,100,2009,99.9,2
21,2009,99.9,2011,99.9,2
21,2011,99.9,2013,98.2,2
21,2013,98.2,2015,97,2
21,2015,97,2017,84.1,2
22,2001,100,2003,100,2
22,2003,100,2005,99.2,2
22,2006,99.5,2007,99.5,1
22,2007,99.5,2009,99.5,2
22,2009,99.5,2011,99.2,2
22,2011,99.2,2013,98.6,2
22,2013,98.6,2015,97.7,2
22,2015,97.7,2017,83.2,2
23,1997,100,2001,100,4
23,2001,100,2003,100,2
23,2003,100,2005,100,2
23,2005,100,2006,99.7,1
23,2006,99.7,2007,91.3,1
23,2007,91.3,2009,74.9,2
23,2009,74.9,2011,74.1,2
23,2013,74.3,2015,73.4,2
24,1930,100,2001,70.4,71
24,2005,72.1,2006,63.8,1
24,2006,63.8,2007,63.3,1
24,2007,63.3,2009,63.3,2
24,2011,75,2013,74.3,2
24,2013,74.3,2015,73.8,2
24,2015,73.8,2017,73.5,2
25,1977,100,2001,97.3,24
25,2001,97.3,2003,71.5,2
25,2003,71.5,2005,68.1,2
25,2005,68.1,2006,68.1,1
25,2006,68.1,2007,68.1,1
25,2009,71.6,2011,71.6,2
25,2013,75.2,2015,75.1,2
25,2015,75.1,2017,75,2
26,1930,100,2001,73.3,71
26,2001,73.3,2003,73.2,2
26,2003,73.2,2005,68.1,2
26,2005,68.1,2006,67.3,1
26,2006,67.3,2007,66.2,1
26,2007,66.2,2009,62,2
26,2009,62,2011,62,2
26,2013,76.6,2015,76.1,2
26,2015,76.1,2017,74.6,2
27,1930,100,2001,74.3,71
27,2001,74.3,2003,74.2,2
27,2003,74.2,2005,72.7,2
27,2005,72.7,2006,72.7,1
27,2006,72.7,2007,71.2,1
27,2007,71.2,2009,70.4,2
27,2009,70.4,2011,70.4,2
27,2013,74.4,2015,73.6,2
27,2015,73.6,2017,73.3,2
28,1970,100,2001,70.9,31
28,2003,71.8,2005,71.8,2
28,2005,71.8,2006,70.4,1
28,2006,70.4,2007,69.7,1
28,2007,69.7,2009,68.9,2
28,2009,68.9,2011,64.4,2
28,2011,64.4,2013,64.4,2
28,2013,64.4,2015,64.1,2
28,2015,64.1,2017,63.1,2
29,1956,100,2014,66.3,58
29,2015,66.4,2017,66.4,2
30,1975,100,2000,93.1,25
30,2000,93.1,2002,73.6,2
30,2002,73.6,2004,73.1,2
30,2004,73.1,2006,73.1,2
30,2006,73.1,2008,72.9,2
30,2008,72.9,2010,72.6,2
30,2010,72.6,2012,72.5,2
30,2012,72.5,2014,70.9,2
30,2014,70.9,2016,70.7,2
31,1975,100,2000,93,25
31,2000,93,2002,72.7,2
31,2004,73.5,2006,71.7,2
31,2006,71.7,2008,70.2,2
31,2008,70.2,2010,69.8,2
31,2010,69.8,2012,68.1,2
31,2012,68.1,2014,66.3,2
31,2014,66.3,2016,66.2,2
32,1974,100,2000,96.1,26
32,2000,96.1,2002,74.3,2
32,2002,74.3,2004,73,2
32,2004,73,2006,72.7,2
32,2006,72.7,2008,69.4,2
32,2008,69.4,2010,68.8,2
32,2010,68.8,2012,68.7,2
32,2012,68.7,2014,67.5,2
32,2014,67.5,2016,67.1,2
33,1975,100,2000,94.2,25
33,2000,94.2,2002,73.8,2
33,2004,74.8,2006,72,2
33,2006,72,2008,71.9,2
33,2008,71.9,2010,71.2,2
33,2010,71.2,2012,69.9,2
33,2012,69.9,2014,68.8,2
33,2014,68.8,2016,68.6,2
34,1974,100,2000,96.4,26
34,2000,96.4,2002,73.9,2
34,2002,73.9,2005,73.6,3
34,2006,74.1,2008,73.9,2
34,2008,73.9,2010,73.7,2
34,2010,73.7,2012,73.7,2
34,2012,73.7,2014,72.7,2
34,2014,72.7,2016,72.4,2
35,1974,100,2000,96.2,26
35,2000,96.2,2002,74.5,2
35,2002,74.5,2005,71.2,3
35,2006,72.5,2008,72.4,2
35,2008,72.4,2010,72.2,2
35,2010,72.2,2012,66.8,2
35,2012,66.8,2014,65.1,2
35,2014,65.1,2016,64.6,2
36,1973,100,2000,94.8,27
36,2000,94.8,2002,74,2
36,2002,74,2005,73.4,3
36,2005,73.4,2006,72.8,1
36,2006,72.8,2008,72.7,2
36,2008,72.7,2010,72,2
36,2010,72,2012,68.6,2
36,2012,68.6,2014,66.3,2
36,2014,66.3,2016,65.2,2
37,1975,100,2000,92.4,25
37,2000,92.4,2002,72.7,2
37,2002,72.7,2004,65.6,2
37,2008,70.7,2010,70.5,2
37,2010,70.5,2012,69.3,2
37,2012,69.3,2014,67.7,2
37,2014,67.7,2016,67.1,2
38,1973,100,2000,94.3,27
38,2000,94.3,2002,74.7,2
38,2002,74.7,2004,73.6,2
38,2006,73.7,2008,73.7,2
38,2008,73.7,2010,73.5,2
38,2010,73.5,2012,72.3,2
38,2012,72.3,2014,70.1,2
38,2014,70.1,2016,70,2
39,1973,100,2004,75,31
39,2004,75,2006,75,2
39,2006,75,2008,74.1,2
39,2010,74.4,2012,74.3,2
39,2012,74.3,2014,72.6,2
39,2014,72.6,2016,72.3,2
40,1973,100,2004,75,31
40,2004,75,2006,75,2
40,2006,75,2008,73.5,2
40,2008,73.5,2010,73.4,2
40,2012,74.6,2014,70.5,2
40,2014,70.5,2016,69.1,2
41,1974,100,2006,75,32
41,2006,75,2008,73.5,2
41,2010,74.6,2012,74.5,2
41,2012,74.5,2014,69.2,2
41,2014,69.2,2016,68.5,2
42,1973,100,2000,91.5,27
42,2000,91.5,2002,71.2,2
42,2002,71.2,2005,68.1,3
42,2006,72.4,2008,66.5,2
42,2008,66.5,2010,66.3,2
42,2010,66.3,2012,66,2
42,2012,66,2014,65.4,2
42,2014,65.4,2016,65.2,2
43,1974,100,2004,72.9,30
43,2004,72.9,2006,66.1,2
43,2008,69.3,2010,67.9,2
44,1982,100,2004,74.7,22
44,2004,74.7,2006,74.3,2
44,2006,74.3,2007,74.3,1
44,2007,74.3,2009,73.1,2
44,2011,73.3,2013,73.2,2
44,2015,100,2017,100,2
45,1982,100,2001,79.6,19
45,2001,79.6,2003,73.3,2
45,2003,73.3,2005,72.7,2
45,2005,72.7,2007,71.3,2
45,2009,71.7,2011,71.6,2
45,2011,71.6,2013,71.2,2
45,2013,71.2,2015,70.7,2
45,2015,70.7,2017,70.7,2
46,1997,100,2001,97.7,4
46,2001,97.7,2003,92.1,2
46,2003,92.1,2005,89.6,2
46,2005,89.6,2007,85.4,2
46,2007,85.4,2009,81,2
46,2009,81,2011,77.7,2
46,2011,77.7,2013,77.7,2
46,2013,77.7,2015,77.7,2
47,1983,100,2001,74.4,18
47,2005,74.8,2007,73.8,2
47,2007,73.8,2009,72.8,2
47,2009,72.8,2011,72.8,2
47,2011,72.8,2013,71.8,2
47,2015,73.3,2017,72.5,2
48,1998,100,2001,95.8,3
48,2001,95.8,2003,91.1,2
48,2003,91.1,2005,88.6,2
48,2005,88.6,2007,85,2
48,2007,85,2009,75,2
48,2009,75,2011,75,2
48,2011,75,2013,74.8,2
48,2013,74.8,2015,74.8,2
48,2015,74.8,2017,74.4,2
49,1983,100,2001,76.5,18
49,2001,76.5,2003,74.8,2
49,2003,74.8,2005,74.8,2
49,2007,75.2,2009,74,2
49,2009,74,2011,74,2
49,2011,74,2013,73.8,2
49,2015,74.1,2017,74.1,2
50,1996,100,2001,97.6,5
50,2001,97.6,2003,90.8,2
50,2003,90.8,2005,88.1,2
50,2005,88.1,2007,83.9,2
50,2007,83.9,2009,77.9,2
50,2009,77.9,2011,76.4,2
50,2011,76.4,2013,74.1,2
50,2013,74.1,2015,74,2
50,2015,74,2017,73.3,2
51,2000,100,2006,73.9,6
51,2010,80,2014,78.1,4
51,2014,78.1,2016,76.4,2
52,1993,100,2006,73.4,13
52,2006,73.4,2010,72.5,4
52,2010,72.5,2014,72.5,4
53,1969,100,2006,62.8,37
53,2006,62.8,2010,62.1,4
53,2010,62.1,2014,55.5,4
54,1993,100,2006,71.8,13
54,2010,73.7,2014,73.7,4
55,1994,100,2006,68.6,12
55,2010,70.4,2014,69.1,4
56,1994,100,2006,57.6,12
57,2000,100,2006,71.6,6
57,2010,74.4,2014,73.9,4
58,2001,100,2006,75,5
58,2010,82,2014,78.6,4
59,1992,100,2006,73.1,14
60,2000,100,2011,93,11
60,2011,93,2015,88.3,4
61,1994,100,2006,73.3,12
61,2006,73.3,2007,73.3,1
61,2007,73.3,2009,73.1,2
61,2009,73.1,2011,71.6,2
61,2011,71.6,2013,71,2
61,2013,71,2015,71,2
61,2015,71,2017,71,2
62,1994,100,2005,84,11
62,2005,84,2007,81.1,2
62,2007,81.1,2009,78.3,2
62,2009,78.3,2011,72.7,2
62,2011,72.7,2013,72.6,2
62,2015,73.8,2017,73.8,2
63,1994,100,2005,83.9,11
63,2005,83.9,2007,80.8,2
63,2007,80.8,2009,77.6,2
63,2009,77.6,2011,73,2
63,2011,73,2013,72.8,2
63,2015,73.6,2017,73.6,2
64,1994,100,2005,85.4,11
64,2005,85.4,2007,77.6,2
64,2007,77.6,2009,77.5,2
64,2009,77.5,2011,74.7,2
64,2011,74.7,2013,74.5,2
64,2013,74.5,2015,73.8,2
64,2015,73.8,2017,73.8,2
65,1994,100,2005,85.3,11
65,2005,85.3,2007,82.3,2
65,2007,82.3,2009,76.1,2
65,2009,76.1,2011,74.2,2
65,2011,74.2,2013,74,2
65,2013,74,2015,73.7,2
65,2015,73.7,2017,73.7,2
66,1997,100,2001,74.7,4
66,2003,88.1,2005,85.7,2
66,2005,85.7,2007,83.6,2
66,2007,83.6,2009,83.5,2
66,2009,83.5,2011,75,2
66,2013,75.5,2015,75.3,2
66,2015,75.3,2017,75.3,2
67,1994,100,2001,79,7
67,2003,87.7,2005,84.9,2
67,2005,84.9,2007,77.3,2
67,2009,78.7,2011,74.7,2
67,2011,74.7,2013,74.7,2
67,2013,74.7,2015,74.6,2
67,2015,74.6,2017,74.2,2
68,1993,100,2003,86.1,10
68,2003,86.1,2005,84.1,2
68,2005,84.1,2007,75.6,2
68,2009,76.1,2011,74.9,2
68,2011,74.9,2013,74.7,2
68,2013,74.7,2015,74.7,2
68,2015,74.7,2017,74.4,2
69,1993,100,2003,86.8,10
69,2003,86.8,2005,84.1,2
69,2005,84.1,2007,75.5,2
69,2009,75.8,2011,74.8,2
69,2011,74.8,2013,74.8,2
69,2013,74.8,2015,74.5,2
69,2015,74.5,2017,73.8,2
70,1994,100,2003,87.7,9
70,2003,87.7,2005,85.1,2
70,2005,85.1,2007,76.8,2
70,2009,77.8,2011,74.6,2
70,2011,74.6,2013,74.4,2
70,2013,74.4,2015,74.4,2
70,2015,74.4,2017,74.3,2
71,1992,100,2003,86,11
71,2003,86,2005,83.4,2
71,2005,83.4,2007,79.7,2
71,2007,79.7,2009,74.9,2
71,2009,74.9,2011,74.9,2
71,2011,74.9,2013,74.8,2
71,2015,75.4,2017,74.9,2
72,1992,100,2003,85.8,11
72,2003,85.8,2005,83.2,2
72,2005,83.2,2007,83.1,2
72,2007,83.1,2009,75,2
72,2009,75,2011,74.8,2
72,2011,74.8,2013,74.7,2
72,2015,75.4,2017,75.2,2
73,1992,100,2001,97.8,9
73,2001,97.8,2003,94.7,2
73,2003,94.7,2005,88.5,2
73,2005,88.5,2007,79.5,2
73,2007,79.5,2009,76.1,2
73,2009,76.1,2011,75.7,2
73,2011,75.7,2013,75.4,2
73,2013,75.4,2015,74.2,2
73,2015,74.2,2017,73.7,2
74,1992,100,2001,97.8,9
74,2001,97.8,2003,94,2
74,2003,94,2005,88.9,2
74,2005,88.9,2007,78.9,2
74,2007,78.9,2009,76.8,2
74,2009,76.8,2011,74.9,2
74,2011,74.9,2013,74,2
74,2013,74,2015,74,2
74,2015,74,2017,73.8,2
75,1992,100,2001,76.1,9
75,2003,84.8,2005,80.2,2
75,2005,80.2,2007,74,2
75,2007,74,2009,73.7,2
75,2009,73.7,2011,72.9,2
75,2011,72.9,2013,72.4,2
75,2015,72.5,2017,72.5,2
76,1994,100,2001,97.4,7
76,2001,97.4,2003,87.2,2
76,2003,87.2,2005,86.1,2
76,2005,86.1,2007,74.5,2
76,2007,74.5,2009,70.4,2
76,2011,71.7,2013,70.8,2
76,2015,72,2017,72,2
77,1995,100,2001,96.4,6
77,2001,96.4,2003,88.4,2
77,2003,88.4,2005,86.5,2
77,2005,86.5,2007,84.1,2
77,2007,84.1,2009,74.7,2
77,2009,74.7,2011,74.1,2
77,2013,74.2,2015,73.5,2
77,2015,73.5,2017,73.5,2
78,1992,100,2001,98.6,9
78,2001,98.6,2003,88,2
78,2003,88,2005,84.7,2
78,2005,84.7,2007,74.5,2
78,2007,74.5,2009,74.5,2
78,2011,74.8,2013,74.2,2
78,2013,74.2,2015,73.9,2
79,1997,100,2001,98,4
79,2001,98,2003,90.5,2
79,2003,90.5,2005,88.3,2
79,2005,88.3,2007,84.7,2
79,2007,84.7,2009,76.4,2
79,2009,76.4,2011,75.5,2
79,2011,75.5,2013,75.2,2
79,2013,75.2,2015,74.6,2
79,2015,74.6,2017,74.1,2
80,1997,100,2001,96.4,4
80,2001,96.4,2003,89.9,2
80,2003,89.9,2005,87.6,2
80,2005,87.6,2007,81.7,2
80,2007,81.7,2009,75.9,2
80,2009,75.9,2011,74.9,2
80,2011,74.9,2013,74.6,2
80,2013,74.6,2015,74.5,2
80,2015,74.5,2017,74.3,2
81,1996,100,2001,98.7,5
81,2001,98.7,2003,90.4,2
81,2003,90.4,2005,87.6,2
81,2005,87.6,2007,85.5,2
81,2007,85.5,2009,75,2
81,2009,75,2011,74.7,2
81,2011,74.7,2013,74.4,2
81,2013,74.4,2015,74.2,2
81,2015,74.2,2017,74,2
82,2004,100,2005,99.9,1
82,2005,99.9,2007,94.9,2
82,2007,94.9,2009,93,2
82,2009,93,2011,89.7,2
82,2011,89.7,2013,89,2
82,2013,89,2015,86.9,2
82,2015,86.9,2017,84.2,2
83,2004,100,2005,99.9,1
83,2005,99.9,2007,93.3,2
83,2007,93.3,2009,91.4,2
83,2009,91.4,2011,88.7,2
83,2011,88.7,2013,87.9,2
83,2013,87.9,2015,85.5,2
83,2015,85.5,2017,82.8,2
84,2000,100,2005,100,5
84,2005,100,2007,78.6,2
84,2009,86.4,2011,84,2
84,2013,84.4,2015,74.2,2
84,2015,74.2,2017,74.2,2
85,2000,100,2005,100,5
85,2005,100,2007,72.3,2
85,2009,87.3,2011,84.4,2
85,2013,84.8,2015,83.2,2
85,2015,83.2,2017,81.5,2
86,2004,100,2005,100,1
86,2005,100,2007,83.5,2
86,2009,92.2,2011,89,2
86,2011,89,2013,85.8,2
86,2013,85.8,2015,84.8,2
86,2015,84.8,2017,84.2,2
87,1999,100,2001,98.3,2
87,2001,98.3,2003,93.5,2
87,2003,93.5,2005,90.1,2
87,2005,90.1,2007,77.1,2
87,2007,77.1,2009,76.7,2
87,2009,76.7,2011,75.8,2
87,2011,75.8,2013,75.5,2
87,2013,75.5,2015,75.4,2
87,2015,75.4,2017,75.1,2
88,1999,100,2001,99.5,2
88,2001,99.5,2003,94.6,2
88,2003,94.6,2005,91.9,2
88,2005,91.9,2007,83.8,2
88,2007,83.8,2009,83.8,2
88,2009,83.8,2011,83,2
88,2013,83.4,2015,82,2
88,2015,82,2017,80.1,2
89,1995,100,2001,98.8,6
89,2001,98.8,2003,89.5,2
89,2003,89.5,2005,87.3,2
89,2005,87.3,2007,83.5,2
89,2007,83.5,2009,80.1,2
89,2009,80.1,2011,78.4,2
89,2011,78.4,2013,77.3,2
89,2013,77.3,2015,76.3,2
89,2015,76.3,2017,75.7,2
90,2007,100,2009,99.8,2
90,2009,99.8,2011,91.4,2
90,2013,92.2,2015,90,2
90,2015,90,2017,86.4,2
91,2007,100,2009,99.9,2
91,2009,99.9,2011,87,2
91,2013,89.4,2015,86.3,2
91,2015,86.3,2017,82.3,2
92,2002,100,2005,97.9,3
92,2005,97.9,2007,90.7,2
92,2007,90.7,2009,88.7,2
92,2009,88.7,2011,85.1,2
92,2011,85.1,2013,80.2,2
92,2013,80.2,2015,77.2,2
92,2015,77.2,2017,76.5,2
93,1974,100,2006,73.8,32
93,2006,73.8,2010,73.6,4
93,2010,73.6,2014,73.5,4
94,1974,100,2006,72.9,32
94,2006,72.9,2010,72.7,4
94,2010,72.7,2014,72.7,4
95,1974,100,2006,71.1,32
95,2006,71.1,2010,70.8,4
95,2010,70.8,2014,70.4,4
96,1974,100,2006,73.5,32
96,2006,73.5,2010,70.5,4
97,1973,100,2013,74.2,40
97,2013,74.2,2017,73.9,4
98,2007,100,2015,85.9,8
99,2007,100,2015,86,8
100,2007,100,2015,86,8
101,2007,100,2015,92.1,8
102,2007,100,2015,74.9,8
103,1972,100,2001,64.7,29
103,2001,64.7,2002,64.5,1
103,2002,64.5,2004,64.5,2
103,2008,74.2,2010,71.4,2
103,2010,71.4,2012,70.2,2
103,2012,70.2,2014,70.2,2
103,2014,70.2,2016,69.9,2
104,1972,100,2002,67.2,30
104,2002,67.2,2004,67.2,2
104,2008,73.9,2010,72.6,2
104,2010,72.6,2012,71.8,2
104,2012,71.8,2014,71.2,2
104,2014,71.2,2016,70.8,2
105,1957,100,2002,68,45
105,2002,68,2004,68,2
105,2008,74.3,2010,73.9,2
105,2010,73.9,2012,73.3,2
105,2012,73.3,2014,72.8,2
105,2014,72.8,2016,72.5,2
106,1971,100,2001,71.5,30
106,2002,75,2004,75,2
106,2004,75,2006,71.9,2
106,2010,72.9,2012,72.6,2
106,2012,72.6,2014,72.6,2
106,2014,72.6,2016,72.6,2
107,1972,100,2001,65.1,29
107,2001,65.1,2002,64.9,1
107,2002,64.9,2004,64.9,2
107,2006,74.7,2008,74,2
107,2008,74,2010,73.5,2
107,2010,73.5,2012,72.9,2
107,2012,72.9,2014,72.9,2
107,2014,72.9,2016,72.7,2
108,1972,100,2001,71.5,29
108,2001,71.5,2002,71.3,1
108,2002,71.3,2004,71.3,2
108,2008,72.6,2010,71.7,2
108,2010,71.7,2012,69.5,2
108,2012,69.5,2014,68.9,2
108,2014,68.9,2016,68.4,2
109,1972,100,2001,65.1,29
109,2002,66.1,2004,66.1,2
109,2008,73.9,2010,73.6,2
109,2010,73.6,2012,71.3,2
109,2012,71.3,2014,70.3,2
109,2014,70.3,2016,70.3,2
110,1986,100,2001,71.5,15
110,2002,72.3,2004,72.3,2
110,2008,73.2,2010,73.2,2
110,2010,73.2,2012,73.2,2
110,2012,73.2,2014,72.8,2
110,2014,72.8,2016,72.6,2
111,1964,100,2001,64.3,37
111,2001,64.3,2002,64.2,1
111,2002,64.2,2004,64.2,2
111,2008,73.5,2010,71.2,2
111,2010,71.2,2012,68.5,2
111,2012,68.5,2014,67.2,2
112,1972,100,2001,64.6,29
112,2001,64.6,2002,64.6,1
112,2002,64.6,2004,64.6,2
112,2008,74.1,2010,72.5,2
112,2010,72.5,2012,71.4,2
112,2012,71.4,2014,70.4,2
112,2014,70.4,2016,70.2,2
113,1964,100,2004,75,40
113,2004,75,2006,74.6,2
113,2006,74.6,2008,74.3,2
113,2008,74.3,2010,72.5,2
113,2010,72.5,2012,70.5,2
113,2012,70.5,2014,69.3,2
113,2014,69.3,2016,69,2
114,1998,100,2001,100,3
114,2001,100,2002,98.9,1
114,2002,98.9,2004,74.9,2
114,2006,85.3,2008,84.8,2
114,2010,85.1,2012,81.7,2
114,2012,81.7,2014,81.5,2
114,2014,81.5,2016,81.2,2
115,1959,100,2001,75,42
115,2001,75,2002,75,1
115,2002,75,2004,74.3,2
115,2008,75,2010,75,2
115,2010,75,2012,74.7,2
115,2012,74.7,2014,74.6,2
115,2014,74.6,2016,74.6,2
116,1969,100,2001,84.7,32
116,2001,84.7,2002,71.1,1
116,2002,71.1,2004,69.9,2
116,2006,70,2008,69.9,2
116,2010,70.8,2012,70.4,2
116,2012,70.4,2014,69.7,2
116,2014,69.7,2016,69.2,2
117,1979,100,2006,74.6,27
117,2006,74.6,2008,74.2,2
117,2008,74.2,2010,74.2,2
117,2010,74.2,2012,74.1,2
117,2012,74.1,2014,74.1,2
117,2014,74.1,2016,73.7,2
118,1980,100,2006,74.9,26
118,2006,74.9,2008,74.6,2
118,2008,74.6,2010,74.6,2
118,2010,74.6,2012,74.6,2
118,2012,74.6,2014,74.4,2
118,2014,74.4,2016,73.9,2
119,1978,100,2001,75,23
119,2001,75,2002,75,1
119,2002,75,2004,74.2,2
119,2006,74.4,2008,74.2,2
119,2008,74.2,2010,73.8,2
119,2010,73.8,2012,72.7,2
119,2012,72.7,2014,72.5,2
120,1978,100,2001,96,23
120,2001,96,2002,96,1
120,2002,96,2004,75,2
120,2004,75,2006,75,2
120,2006,75,2008,75,2
120,2008,75,2010,75,2
120,2010,75,2012,74.6,2
120,2012,74.6,2014,74.5,2
120,2014,74.5,2016,74.5,2
121,2001,66.9,2002,66.9,1
121,2002,66.9,2004,58.9,2
121,2006,100,2008,100,2
121,2008,100,2010,91.5,2
121,2012,92.1,2014,90.2,2
121,2014,90.2,2016,88.2,2
122,1960,100,2001,68,41
122,2002,75,2004,69,2
122,2006,71.9,2008,71.9,2
122,2008,71.9,2010,71.8,2
122,2010,71.8,2012,71.6,2
122,2012,71.6,2014,71.5,2
122,2014,71.5,2016,71.5,2
123,1960,100,2001,68,41
123,2002,75,2004,67.6,2
123,2006,68.3,2008,67,2
123,2008,67,2010,66.4,2
123,2010,66.4,2012,64.4,2
123,2012,64.4,2014,63.7,2
123,2014,63.7,2016,63.7,2
124,1960,100,2001,68,41
124,2002,75,2004,67,2
124,2004,67,2006,66.4,2
124,2008,69,2010,68,2
124,2010,68,2012,68,2
124,2012,68,2014,67.5,2
124,2014,67.5,2016,67.1,2
125,1976,100,2001,67.7,25
125,2002,74,2004,63.4,2
125,2004,63.4,2006,62,2
125,2006,62,2008,61.2,2
125,2010,61.6,2012,59.3,2
125,2012,59.3,2014,58.7,2
125,2014,58.7,2016,58.6,2
126,1960,100,2005,66.1,45
126,2008,73.7,2010,71.2,2
126,2010,71.2,2012,71.1,2
126,2012,71.1,2014,70.7,2
126,2014,70.7,2016,70.4,2
127,2001,74.1,2003,72.5,2
127,2007,100,2009,99.9,2
127,2009,99.9,2011,99.6,2
127,2011,99.6,2013,99.4,2
127,2013,99.4,2015,88.1,2
127,2015,88.1,2017,87.3,2
128,2001,68.1,2003,63.7,2
128,2007,100,2009,99.9,2
128,2009,99.9,2011,96.6,2
128,2011,96.6,2013,93.8,2
128,2013,93.8,2015,86.7,2
128,2015,86.7,2017,85.9,2
129,1975,100,2001,75,26
129,2001,75,2003,74.4,2
129,2003,74.4,2005,74.4,2
129,2005,74.4,2007,74.4,2
129,2007,74.4,2009,72.5,2
129,2009,72.5,2011,70.8,2
129,2011,70.8,2013,70.5,2
129,2013,70.5,2015,70.2,2
129,2015,70.2,2017,70.2,2
130,1969,100,2001,75,32
130,2001,75,2003,71.4,2
130,2003,71.4,2005,71.4,2
130,2005,71.4,2007,71.2,2
130,2007,71.2,2009,69.9,2
130,2011,71.1,2013,70.3,2
130,2013,70.3,2015,69.5,2
130,2015,69.5,2017,69,2
131,1969,100,2001,74.9,32
131,2001,74.9,2003,74.9,2
131,2003,74.9,2005,74.9,2
131,2005,74.9,2007,74.9,2
131,2011,82.7,2013,81.5,2
131,2013,81.5,2015,78.3,2
131,2015,78.3,2017,77,2
132,1969,100,2001,75,32
132,2001,75,2003,75,2
132,2003,75,2005,75,2
132,2005,75,2007,52.1,2
132,2009,54.1,2011,54.1,2
132,2011,54.1,2013,53.2,2
132,2013,53.2,2015,52.8,2
133,1969,100,2003,75,34
133,2003,75,2005,75,2
133,2005,75,2007,72.2,2
133,2009,73.5,2011,72.6,2
133,2011,72.6,2013,71.5,2
133,2013,71.5,2015,70.9,2
134,1969,100,2001,75,32
134,2001,75,2003,74.7,2
134,2003,74.7,2005,74.4,2
134,2005,74.4,2007,71.2,2
134,2007,71.2,2009,71.2,2
134,2011,73,2013,72.1,2
134,2013,72.1,2015,71.8,2
134,2015,71.8,2017,71.6,2
135,1980,100,2001,75,21
135,2001,75,2003,75,2
135,2003,75,2005,75,2
135,2005,75,2007,71.7,2
135,2009,73.4,2011,72.9,2
135,2011,72.9,2013,72,2
135,2015,72.2,2017,71.6,2
136,1980,100,2001,75,21
136,2001,75,2003,75,2
136,2003,75,2005,75,2
136,2005,75,2007,74.1,2
136,2009,75,2011,74.7,2
136,2011,74.7,2013,74.4,2
136,2015,75,2017,74.7,2
137,1980,100,2001,75,21
137,2001,75,2003,75,2
137,2003,75,2005,75,2
137,2005,75,2007,72,2
137,2007,72,2009,72,2
137,2011,72.7,2013,72,2
137,2013,72,2015,71.4,2
137,2015,71.4,2017,71.3,2
138,1980,100,2001,75,21
138,2001,75,2003,75,2
138,2003,75,2005,75,2
138,2005,75,2007,73.1,2
138,2009,75,2011,74.9,2
138,2011,74.9,2013,74.6,2
138,2013,74.6,2015,74.3,2
138,2015,74.3,2017,74,2
139,1980,100,2001,75,21
139,2003,75.3,2005,75,2
139,2005,75,2007,71.1,2
139,2009,73.1,2011,72.8,2
139,2011,72.8,2013,72.4,2
139,2013,72.4,2015,72.1,2
139,2015,72.1,2017,72.1,2
140,1980,100,2001,75,21
140,2001,75,2003,75,2
140,2003,75,2005,75,2
140,2005,75,2007,73.2,2
140,2007,73.2,2009,69.7,2
140,2009,69.7,2011,69.7,2
140,2011,69.7,2013,68.8,2
140,2013,68.8,2015,68.8,2
140,2015,68.8,2017,68.8,2
141,1980,100,2001,75,21
141,2001,75,2003,75,2
141,2003,75,2005,75,2
141,2005,75,2007,70.2,2
141,2007,70.2,2009,70.2,2
141,2011,70.7,2013,70.2,2
141,2013,70.2,2015,70,2
142,1981,100,2001,75,20
142,2001,75,2003,75,2
142,2003,75,2005,75,2
142,2005,75,2007,67.7,2
142,2007,67.7,2009,67.7,2
142,2011,68.8,2013,68.4,2
142,2013,68.4,2015,68.1,2
143,1981,100,2001,75,20
143,2001,75,2003,75,2
143,2003,75,2005,75,2
143,2005,75,2007,70.6,2
143,2007,70.6,2009,70.6,2
143,2009,70.6,2011,70.6,2
143,2011,70.6,2013,70.3,2
143,2013,70.3,2015,69.9,2
143,2015,69.9,2017,69.8,2
144,2001,45.9,2003,45.9,2
144,2003,45.9,2005,45.9,2
144,2005,45.9,2007,35,2
144,2011,100,2013,99.9,2
144,2013,99.9,2015,98.4,2
144,2015,98.4,2017,90.6,2
145,1965,100,2001,75,36
145,2001,75,2003,74.9,2
145,2003,74.9,2005,74.9,2
145,2005,74.9,2007,70,2
145,2007,70,2009,70,2
145,2009,70,2011,68.6,2
145,2011,68.6,2013,67.5,2
145,2013,67.5,2015,67.3,2
145,2015,67.3,2017,66.9,2
146,1975,100,2001,75,26
146,2001,75,2003,74.1,2
146,2003,74.1,2005,73.6,2
146,2005,73.6,2007,68.7,2
146,2011,71.9,2013,70.9,2
146,2013,70.9,2015,69.9,2
146,2015,69.9,2017,69.8,2
147,2001,70.7,2003,70.1,2
147,2003,70.1,2005,69.8,2
147,2007,100,2009,95.8,2
147,2009,95.8,2011,94,2
147,2011,94,2013,93.5,2
147,2013,93.5,2015,89.2,2
147,2015,89.2,2017,86.2,2
148,2001,74.5,2003,74.5,2
148,2003,74.5,2005,74.3,2
148,2007,100,2009,94.8,2
148,2009,94.8,2011,93.6,2
148,2011,93.6,2013,91.6,2
148,2013,91.6,2015,86.7,2
148,2015,86.7,2017,83.6,2
149,2001,39.7,2003,39.2,2
149,2003,39.2,2005,39.2,2
149,2007,100,2009,95.5,2
149,2009,95.5,2011,93.5,2
149,2011,93.5,2013,92.2,2
149,2013,92.2,2015,87.7,2
149,2015,87.7,2017,84.7,2
150,2001,74.2,2003,73.4,2
150,2007,100,2009,98.6,2
150,2009,98.6,2011,97.8,2
150,2011,97.8,2013,97.4,2
150,2013,97.4,2015,92.5,2
150,2015,92.5,2017,89.3,2
151,1999,100,2005,100,6
151,2005,100,2007,84.6,2
151,2007,84.6,2009,79.2,2
151,2009,79.2,2011,77,2
151,2011,77,2013,76,2
151,2013,76,2015,74.2,2
151,2015,74.2,2017,71.2,2
152,1980,100,2005,75,25
152,2005,75,2007,66.1,2
152,2009,67.4,2011,67.3,2
152,2011,67.3,2013,67.1,2
152,2015,67.3,2017,66.9,2
153,1969,100,2005,75,36
153,2005,75,2007,70.8,2
153,2009,71.4,2011,70.3,2
153,2011,70.3,2013,69,2
153,2013,69,2015,68.3,2
153,2015,68.3,2017,67.7,2
154,1990,100,2001,94.9,11
154,2003,96.5,2005,74.9,2
154,2005,74.9,2007,74.8,2
154,2007,74.8,2009,74.7,2
154,2009,74.7,2011,74.1,2
154,2013,74.3,2015,73.8,2
154,2015,73.8,2017,73.8,2
155,1957,100,2010,70.9,53
155,2010,70.9,2014,65.6,4
156,1957,100,2006,61.7,49
156,2006,61.7,2010,61.1,4
157,2011,95.4,2015,92.6,4
158,1957,100,2001,63.1,44
158,2002,63.4,2004,62.6,2
158,2006,69.1,2008,69.1,2
158,2008,69.1,2010,68.8,2
158,2010,68.8,2012,68.4,2
158,2012,68.4,2014,67.8,2
158,2014,67.8,2016,67.5,2
159,1957,100,2001,64,44
159,2002,64.6,2004,63.5,2
159,2006,68.5,2008,68.5,2
159,2008,68.5,2010,67.9,2
159,2010,67.9,2012,67.7,2
159,2012,67.7,2014,67.1,2
159,2014,67.1,2016,67,2
160,2009,100,2010,100,1
160,2010,100,2012,99.8,2
160,2012,99.8,2014,99.6,2
160,2014,99.6,2016,99.5,2
161,1976,100,2001,67.7,25
161,2001,67.7,2004,65,3
161,2008,69.3,2010,67.9,2
161,2010,67.9,2012,65.2,2
161,2012,65.2,2014,65.1,2
161,2014,65.1,2016,64.6,2
162,1984,100,2004,75,20
162,2004,75,2006,74.6,2
162,2006,74.6,2008,74.5,2
162,2008,74.5,2009,74.5,1
162,2009,74.5,2011,73.9,2
162,2011,73.9,2013,73.7,2
162,2013,73.7,2015,73.7,2
162,2015,73.7,2017,73.4,2
163,1984,100,2001,74.2,17
163,2001,74.2,2002,74.2,1
163,2002,74.2,2004,74.1,2
163,2006,74.7,2008,74,2
163,2008,74,2009,73.7,1
163,2011,73.9,2013,73.7,2
163,2013,73.7,2015,73.7,2
163,2015,73.7,2017,73.2,2
164,1982,100,2001,74.4,19
164,2001,74.4,2002,71.5,1
164,2006,74.2,2008,74,2
164,2008,74,2009,74,1
164,2009,74,2011,73.9,2
164,2011,73.9,2013,73.7,2
164,2013,73.7,2015,73.7,2
164,2015,73.7,2017,73.5,2
165,1981,100,2002,75,21
165,2002,75,2004,64.9,2
165,2004,64.9,2006,62.2,2
165,2009,74.4,2011,74.1,2
165,2013,74.2,2015,73.9,2
165,2015,73.9,2017,73.4,2
166,1979,100,2002,75,23
166,2002,75,2004,75,2
166,2004,75,2006,75,2
166,2006,75,2008,73.7,2
166,2009,74.1,2011,73.3,2
166,2013,73.8,2015,73.7,2
166,2015,73.7,2017,73.1,2
167,1981,100,2001,73.5,20
167,2001,73.5,2002,72.3,1
167,2002,72.3,2004,72,2
167,2004,72,2006,71.9,2
167,2006,71.9,2008,71.2,2
167,2009,73,2011,72.1,2
167,2011,72.1,2013,72.1,2
167,2013,72.1,2015,71.3,2
167,2015,71.3,2017,70.3,2
168,1968,100,2001,74.9,33
168,2001,74.9,2002,71.5,1
168,2002,71.5,2004,71.4,2
168,2004,71.4,2006,71,2
168,2006,71,2008,70.7,2
168,2009,72.5,2011,71.9,2
168,2011,71.9,2013,71.4,2
168,2013,71.4,2015,71.3,2
168,2015,71.3,2017,71,2
169,1976,100,2001,74.6,25
169,2001,74.6,2002,71.4,1
169,2002,71.4,2004,71.2,2
169,2004,71.2,2006,71,2
169,2006,71,2008,71,2
169,2009,73.9,2011,73.3,2
169,2011,73.3,2013,72.8,2
169,2015,73.6,2017,72.9,2
170,1980,100,2001,100,21
170,2001,100,2002,75,1
170,2002,75,2004,75,2
170,2004,75,2006,73.3,2
170,2006,73.3,2008,72.9,2
170,2008,72.9,2009,72.9,1
170,2009,72.9,2011,70.6,2
170,2011,70.6,2013,69.4,2
170,2013,69.4,2015,65.2,2
170,2015,65.2,2017,64.3,2
171,1979,100,2001,74.3,22
171,2001,74.3,2002,57.5,1
171,2002,57.5,2004,56.9,2
171,2004,56.9,2006,52.9,2
171,2006,52.9,2008,51.5,2
171,2009,72.3,2011,66.8,2
171,2011,66.8,2013,64.2,2
171,2013,64.2,2015,63.6,2
171,2015,63.6,2017,63,2
172,1957,100,2001,75,44
172,2001,75,2003,73.5,2
172,2003,73.5,2005,73.5,2
172,2005,73.5,2006,73.4,1
172,2008,73.7,2010,71.7,2
172,2010,71.7,2012,71.5,2
172,2014,72.2,2016,71.9,2
173,1983,100,2010,73.2,27
173,2012,73.6,2014,73.6,2
173,2014,73.6,2016,73.5,2
174,1983,100,2010,73,27
174,2012,74.1,2014,74,2
174,2014,74,2016,73.6,2
175,1936,100,2001,99.8,65
175,2001,99.8,2003,73.4,2
175,2005,74.2,2007,57.7,2
175,2007,57.7,2008,57.7,1
175,2010,71.2,2012,70.8,2
175,2012,70.8,2014,70.7,2
175,2014,70.7,2016,70.5,2
176,2009,100,2010,99.1,1
176,2012,99.2,2014,99.1,2
176,2014,99.1,2016,96.5,2
177,1961,100,2010,74.9,49
177,2012,75.4,2014,75.4,2
177,2014,75.4,2016,75.2,2
178,1962,100,2001,75,39
178,2001,75,2002,75,1
178,2002,75,2004,75,2
178,2004,75,2007,75,3
178,2007,75,2008,74.7,1
178,2008,74.7,2009,74.7,1
178,2009,74.7,2010,71.5,1
178,2012,72.3,2014,72.1,2
178,2014,72.1,2016,72,2
179,1984,100,2010,73.8,26
179,2012,73.9,2014,73.9,2
179,2014,73.9,2016,73.7,2
180,1985,100,2001,99.7,16
180,2001,99.7,2003,92.7,2
180,2003,92.7,2006,85,3
180,2008,93,2010,92.7,2
180,2010,92.7,2012,91.1,2
180,2012,91.1,2014,90.8,2
180,2014,90.8,2016,88.6,2
181,1993,100,2001,96.1,8
181,2001,96.1,2003,96.1,2
181,2003,96.1,2005,96.1,2
181,2005,96.1,2007,89.2,2
181,2007,89.2,2008,81,1
181,2008,81,2010,75.2,2
181,2010,75.2,2012,74.9,2
181,2012,74.9,2014,74.8,2
181,2014,74.8,2016,74.7,2
182,1964,100,2007,76.8,43
182,2007,76.8,2009,74.2,2
182,2009,74.2,2011,73.7,2
182,2011,73.7,2013,73.6,2
182,2013,73.6,2015,72.9,2
182,2015,72.9,2017,72.9,2
183,1970,100,2007,79.8,37
183,2007,79.8,2009,73.6,2
183,2011,73.9,2013,73.7,2
183,2013,73.7,2015,73.4,2
183,2015,73.4,2017,73.3,2
184,1970,100,2007,75.2,37
184,2007,75.2,2009,73.5,2
184,2013,75,2015,72.1,2
184,2015,72.1,2017,72.1,2
185,1970,100,2007,76.2,37
185,2007,76.2,2009,73.2,2
185,2011,75.3,2013,75.2,2
185,2013,75.2,2015,71.9,2
185,2015,71.9,2017,71.8,2
186,1970,100,2007,77.2,37
186,2007,77.2,2009,73.5,2
186,2011,75.4,2013,75.3,2
186,2013,75.3,2015,74,2
186,2015,74,2017,73.6,2
187,1970,100,2007,75.6,37
187,2007,75.6,2009,73.1,2
187,2013,74.1,2015,72.4,2
187,2015,72.4,2017,72.4,2
188,1969,100,2007,78,38
188,2007,78,2009,74.4,2
188,2011,76.2,2013,74.7,2
188,2013,74.7,2015,70.3,2
188,2015,70.3,2017,69.8,2
189,1969,100,2007,73.4,38
189,2011,79.2,2013,78.8,2
189,2013,78.8,2015,75.1,2
189,2015,75.1,2017,73.4,2
190,1991,100,2007,75,16
190,2007,75,2009,74.9,2
190,2009,74.9,2011,74.9,2
190,2011,74.9,2013,74.9,2
190,2013,74.9,2015,74.7,2
190,2015,74.7,2017,74.6,2
191,1994,100,2007,75.1,13
191,2007,75.1,2009,72.1,2
191,2011,72.2,2013,72.1,2
191,2013,72.1,2015,71,2
192,1996,100,2009,84.5,13
192,2009,84.5,2011,75.4,2
192,2011,75.4,2013,75.3,2
192,2013,75.3,2015,73.8,2
193,2003,100,2006,99.8,3
193,2006,99.8,2008,92.8,2
193,2008,92.8,2010,84.6,2
193,2010,84.6,2012,84.3,2
193,2012,84.3,2014,84,2
193,2014,84,2016,83.7,2
194,2012,100,2014,96.7,2
194,2014,96.7,2016,94.3,2
195,2012,100,2014,97.1,2
195,2014,97.1,2016,94.4,2
196,1996,100,2007,75.9,11
196,2007,75.9,2009,74.5,2
196,2009,74.5,2011,74.2,2
196,2011,74.2,2013,74.1,2
196,2013,74.1,2015,73.6,2
196,2015,73.6,2017,73.3,2
197,1998,100,2007,94,9
197,2007,94,2011,90.8,4
197,2011,90.8,2013,90.7,2
197,2013,90.7,2015,88.4,2
197,2015,88.4,2017,86.6,2
198,1952,100,2000,64.4,48
198,2000,64.4,2002,64.4,2
198,2004,75,2006,75,2
198,2006,75,2008,73.2,2
198,2008,73.2,2010,71.5,2
198,2010,71.5,2012,70.7,2
198,2014,72.6,2016,72.6,2
199,1951,100,2000,75,49
199,2000,75,2004,71.5,4
199,2004,71.5,2006,71.5,2
199,2006,71.5,2008,69.7,2
199,2008,69.7,2010,68.6,2
199,2010,68.6,2012,66.6,2
199,2014,69,2016,68.2,2
200,1968,100,2000,75.1,32
200,2000,75.1,2004,75,4
200,2004,75,2006,75,2
200,2006,75,2008,74,2
200,2008,74,2010,73.6,2
200,2010,73.6,2012,73,2
201,1951,100,2004,68.3,53
201,2004,68.3,2005,67.7,1
201,2005,67.7,2007,64.1,2
201,2007,64.1,2009,64.1,2
201,2013,68.9,2015,68.4,2
202,1964,100,2005,68.5,41
202,2005,68.5,2007,63.9,2
202,2007,63.9,2009,62.6,2
202,2013,65,2015,64.6,2
202,2015,64.6,2017,64.6,2
203,1956,100,2006,68.2,50
203,2010,71,2014,70.5,4
203,2014,70.5,2015,70.5,1
204,1961,100,2005,71.6,44
204,2005,71.6,2007,71.5,2
204,2007,71.5,2009,71.4,2
204,2011,72.5,2013,72.5,2
204,2013,72.5,2015,71.9,2
204,2015,71.9,2017,71.9,2
205,1961,100,2005,75,44
205,2005,75,2007,73.6,2
205,2007,73.6,2009,73.4,2
205,2009,73.4,2011,72.8,2
205,2011,72.8,2013,72.4,2
205,2013,72.4,2015,72.3,2
206,1964,100,2003,73.5,39
206,2003,73.5,2005,73.5,2
206,2005,73.5,2007,73.4,2
206,2007,73.4,2009,73,2
206,2011,73.1,2013,72.9,2
206,2013,72.9,2015,72.9,2
207,1964,100,2001,73.1,37
207,2001,73.1,2003,68.8,2
207,2003,68.8,2005,67.5,2
207,2005,67.5,2007,67.5,2
207,2007,67.5,2009,66.2,2
207,2009,66.2,2011,66.2,2
207,2013,66.4,2017,64,4
208,1965,100,2001,71.9,36
208,2005,75,2007,75,2
208,2007,75,2009,72.5,2
208,2013,73.3,2015,73.3,2
208,2015,73.3,2017,73.3,2
209,1949,100,2001,73.4,52
209,2001,73.4,2003,71.8,2
209,2003,71.8,2005,71.5,2
209,2007,73.5,2009,73.5,2
209,2009,73.5,2011,73.3,2
209,2011,73.3,2013,73.2,2
209,2013,73.2,2015,72.7,2
209,2015,72.7,2017,72.5,2
210,1949,100,2001,75,52
210,2001,75,2003,75,2
210,2003,75,2005,74.4,2
210,2005,74.4,2007,74,2
210,2007,74,2009,74,2
210,2009,74,2011,73.8,2
210,2011,73.8,2013,73.2,2
210,2013,73.2,2015,72.9,2
210,2015,72.9,2017,72.9,2
211,2004,100,2008,75,4
211,2008,75,2012,75,4
211,2012,75,2016,74.1,4
212,1930,100,2008,59.9,78
212,2008,59.9,2010,58.2,2
212,2010,58.2,2012,56.2,2
213,1988,100,2006,54.5,18
213,2010,57.2,2014,49.9,4
214,1988,100,2008,75,20
214,2008,75,2012,75,4
214,2012,75,2016,72.8,4
215,1959,100,2006,74,47
215,2006,74,2008,73,2
215,2010,73.2,2012,72.5,2
215,2012,72.5,2014,72.2,2
216,1959,100,2001,74.9,42
216,2001,74.9,2002,74.9,1
216,2002,74.9,2004,74.3,2
216,2006,74.4,2008,73.5,2
216,2008,73.5,2010,73.5,2
216,2010,73.5,2012,72.1,2
216,2012,72.1,2014,71.8,2
216,2014,71.8,2016,71.6,2
217,1964,100,2001,74.8,37
217,2001,74.8,2002,74.6,1
217,2002,74.6,2004,74.6,2
217,2004,74.6,2006,72.9,2
217,2006,72.9,2008,71.7,2
217,2010,73.6,2012,71.2,2
217,2014,72.6,2016,72.4,2
218,1993,100,2001,73.9,8
218,2001,73.9,2002,47,1
218,2004,73.9,2006,72.7,2
218,2006,72.7,2008,72.7,2
218,2008,72.7,2010,71.5,2
218,2012,73.3,2014,72.9,2
218,2014,72.9,2016,72.6,2
219,1993,100,2001,100,8
219,2001,100,2002,75,1
219,2002,75,2004,74,2
219,2004,74,2006,73,2
219,2006,73,2008,72.6,2
219,2008,72.6,2010,72.1,2
220,2001,73.7,2002,73.7,1
220,2002,73.7,2004,65,2
220,2006,67.8,2008,58.9,2
220,2010,93.2,2012,89.9,2
220,2012,89.9,2014,87.1,2
220,2014,87.1,2016,84.9,2
221,1993,100,2001,73.4,8
221,2001,73.4,2002,40,1
221,2006,74.9,2008,74.5,2
221,2008,74.5,2010,70.9,2
221,2012,71.3,2014,70.8,2
222,1993,100,2001,73.8,8
222,2001,73.8,2004,47.8,3
222,2006,71.3,2008,70.5,2
222,2008,70.5,2010,69.5,2
222,2012,72.2,2014,72,2
222,2014,72,2016,71.8,2
223,1959,100,2001,74.9,42
223,2001,74.9,2002,74.9,1
223,2002,74.9,2004,74.9,2
223,2004,74.9,2006,74.9,2
223,2006,74.9,2008,72.8,2
223,2010,74.2,2012,70.8,2
224,1993,100,2001,75,8
224,2001,75,2002,75,1
224,2002,75,2004,75,2
224,2004,75,2006,75,2
224,2006,75,2008,75,2
224,2008,75,2010,75,2
224,2010,75,2012,74.5,2
224,2012,74.5,2014,73.7,2
224,2014,73.7,2016,73.4,2
225,1993,100,2001,74.9,8
225,2001,74.9,2002,74.6,1
225,2002,74.6,2004,73.6,2
225,2004,73.6,2006,72.1,2
225,2006,72.1,2008,69.9,2
225,2008,69.9,2010,69.8,2
225,2010,69.8,2012,69.1,2
225,2014,70.7,2016,70.7,2
226,1993,100,2001,75,8
226,2001,75,2002,75,1
226,2002,75,2004,75,2
226,2004,75,2006,73.9,2
226,2008,74.4,2010,73.9,2
226,2010,73.9,2012,71,2
226,2012,71,2014,70.7,2
227,1993,100,2001,75,8
227,2001,75,2002,75,1
227,2002,75,2004,75,2
227,2004,75,2006,74.9,2
227,2006,74.9,2008,74.9,2
227,2008,74.9,2010,74.9,2
227,2010,74.9,2012,74.2,2
227,2012,74.2,2014,73.9,2
227,2014,73.9,2016,73.9,2
228,1993,100,2001,99.4,8
228,2001,99.4,2002,74.7,1
228,2002,74.7,2004,74.1,2
228,2004,74.1,2006,73.4,2
228,2006,73.4,2008,73.4,2
228,2008,73.4,2010,71.2,2
228,2010,71.2,2012,70.9,2
229,1993,100,2001,72.5,8
229,2002,75,2004,74.1,2
229,2004,74.1,2006,73.4,2
229,2006,73.4,2008,73.4,2
229,2008,73.4,2010,73.3,2
229,2010,73.3,2012,70.7,2
229,2014,71,2016,70.8,2
230,1993,100,2001,74.2,8
230,2001,74.2,2002,74.2,1
230,2002,74.2,2004,74,2
230,2006,74.3,2008,73.9,2
230,2008,73.9,2010,73.5,2
230,2010,73.5,2012,71.9,2
230,2014,78.2,2016,76.8,2
231,1993,100,2001,73.4,8
231,2001,73.4,2002,73.4,1
231,2002,73.4,2004,72.7,2
231,2004,72.7,2006,71.8,2
231,2006,71.8,2008,71.8,2
231,2008,71.8,2010,62.9,2
231,2010,62.9,2012,62.2,2
231,2012,62.2,2014,61.8,2
231,2014,61.8,2016,61.2,2
232,1993,100,2001,73.5,8
232,2001,73.5,2002,73.5,1
232,2002,73.5,2004,73.5,2
232,2004,73.5,2006,72.1,2
232,2006,72.1,2008,70.7,2
232,2008,70.7,2010,66.6,2
232,2010,66.6,2012,65.6,2
232,2012,65.6,2014,64.8,2
232,2014,64.8,2016,62.3,2
233,1993,100,2001,75,8
233,2001,75,2002,75,1
233,2002,75,2004,75,2
233,2004,75,2006,74,2
233,2006,74,2008,73.8,2
233,2008,73.8,2010,72.8,2
233,2010,72.8,2012,71.9,2
233,2014,72.1,2016,71.1,2
234,1961,100,2001,72.9,40
234,2001,72.9,2002,69.8,1
234,2004,69.9,2006,68.7,2
234,2006,68.7,2008,68.5,2
234,2008,68.5,2010,67.9,2
234,2012,69.2,2014,67.9,2
234,2014,67.9,2016,67.5,2
235,1961,100,2001,71.6,40
235,2001,71.6,2002,60.9,1
235,2002,60.9,2004,60.8,2
235,2006,66.2,2008,65.8,2
235,2008,65.8,2010,65.7,2
235,2012,66.3,2014,66.2,2
235,2014,66.2,2016,64.5,2
236,2002,73,2004,65.1,2
236,2004,65.1,2006,62.6,2
236,2006,62.6,2008,60.4,2
236,2012,63.9,2014,63.1,2
236,2014,63.1,2016,63,2
237,1969,100,2001,66.7,32
237,2001,66.7,2002,55.7,1
237,2006,63.5,2008,61,2
237,2008,61,2010,60.9,2
237,2012,76.8,2014,76.5,2
237,2014,76.5,2016,74.6,2
238,1965,100,2001,64.1,36
238,2002,66.6,2004,66.6,2
238,2006,80,2008,78,2
238,2008,78,2010,77.8,2
238,2012,80.8,2014,78.6,2
238,2014,78.6,2016,78,2
239,1976,100,2001,75,25
239,2001,75,2004,75,3
239,2004,75,2006,75,2
239,2006,75,2008,73,2
239,2008,73,2010,70.7,2
239,2010,70.7,2012,69.8,2
239,2012,69.8,2014,69.8,2
239,2014,69.8,2016,69.8,2
240,1960,100,2001,74.8,41
240,2001,74.8,2004,73.4,3
240,2004,73.4,2006,73.4,2
240,2006,73.4,2008,70.6,2
240,2008,70.6,2010,67.1,2
240,2010,67.1,2012,66.2,2
240,2012,66.2,2014,65.3,2
241,1961,100,2001,74.4,40
241,2001,74.4,2002,74.4,1
241,2002,74.4,2004,71.1,2
241,2004,71.1,2006,70.2,2
241,2006,70.2,2008,69.7,2
241,2008,69.7,2010,67.6,2
241,2010,67.6,2012,67.5,2
241,2012,67.5,2014,67.3,2
241,2014,67.3,2016,66.8,2
242,1961,100,2001,74.2,40
242,2002,74.7,2004,72.8,2
242,2004,72.8,2006,72,2
242,2006,72,2008,62.8,2
242,2008,62.8,2010,61.9,2
242,2010,61.9,2012,60.8,2
242,2012,60.8,2014,60.4,2
242,2014,60.4,2016,60.2,2
243,1961,100,2001,74.6,40
243,2001,74.6,2002,74.4,1
243,2002,74.4,2004,72.5,2
243,2004,72.5,2006,69.5,2
243,2006,69.5,2008,68.5,2
243,2008,68.5,2010,67,2
243,2010,67,2012,66,2
243,2012,66,2014,65.4,2
243,2014,65.4,2016,65,2
244,1961,100,2001,74.4,40
244,2001,74.4,2002,74.4,1
244,2002,74.4,2004,73.1,2
244,2004,73.1,2006,71.1,2
244,2006,71.1,2008,70.1,2
244,2008,70.1,2010,67.5,2
244,2010,67.5,2012,66.4,2
244,2012,66.4,2014,66.1,2
244,2014,66.1,2016,65.7,2
245,1961,100,2001,74.9,40
245,2001,74.9,2002,74.8,1
245,2002,74.8,2004,68.9,2
245,2006,71.6,2008,70.9,2
245,2008,70.9,2010,69.8,2
245,2010,69.8,2012,69.3,2
245,2012,69.3,2014,69.1,2
245,2014,69.1,2016,68.9,2
246,1961,100,2001,74.9,40
246,2001,74.9,2002,74.9,1
246,2002,74.9,2004,70.8,2
246,2004,70.8,2006,70,2
246,2006,70,2008,69.9,2
246,2008,69.9,2010,68.6,2
246,2010,68.6,2012,68.6,2
246,2012,68.6,2014,68,2
246,2014,68,2016,67.7,2
247,1961,100,2001,74.9,40
247,2001,74.9,2002,74.9,1
247,2002,74.9,2004,73.9,2
247,2004,73.9,2006,73.1,2
247,2006,73.1,2008,72.6,2
247,2008,72.6,2010,70.9,2
247,2010,70.9,2012,70.9,2
247,2012,70.9,2014,70.6,2
247,2014,70.6,2016,70.2,2
248,1961,100,2001,74.9,40
248,2001,74.9,2002,74.9,1
248,2002,74.9,2004,73.1,2
248,2004,73.1,2006,71.7,2
248,2006,71.7,2008,71.1,2
248,2008,71.1,2010,67.9,2
248,2010,67.9,2012,67.1,2
248,2012,67.1,2014,66.8,2
248,2014,66.8,2016,66.3,2
249,1961,100,2001,74.7,40
249,2001,74.7,2002,74.7,1
249,2002,74.7,2004,72.2,2
249,2004,72.2,2006,71.7,2
249,2006,71.7,2008,71.1,2
249,2008,71.1,2010,69.3,2
249,2010,69.3,2012,69,2
249,2012,69,2014,67.6,2
249,2014,67.6,2016,67.2,2
250,1961,100,2001,74.9,40
250,2001,74.9,2002,74.9,1
250,2002,74.9,2004,74.5,2
250,2004,74.5,2006,72.8,2
250,2006,72.8,2008,72.6,2
250,2008,72.6,2010,71.6,2
250,2010,71.6,2012,71.5,2
250,2012,71.5,2014,71.2,2
250,2014,71.2,2016,70.8,2
251,1962,100,2001,74.9,39
251,2001,74.9,2002,74.9,1
251,2002,74.9,2004,73.5,2
251,2006,74.1,2008,73.9,2
251,2008,73.9,2010,73.1,2
251,2010,73.1,2012,73.1,2
251,2012,73.1,2014,72.5,2
251,2014,72.5,2016,72.4,2
252,1962,100,2001,74.8,39
252,2001,74.8,2002,74.8,1
252,2002,74.8,2004,70,2
252,2006,72.6,2008,72.2,2
252,2008,72.2,2010,71.6,2
252,2010,71.6,2012,71.6,2
252,2012,71.6,2014,71.3,2
252,2014,71.3,2016,70.5,2
253,1962,100,2001,74.5,39
253,2001,74.5,2002,74.5,1
253,2002,74.5,2004,71.7,2
253,2004,71.7,2006,70.4,2
253,2010,72.7,2012,72.4,2
253,2012,72.4,2014,71.9,2
253,2014,71.9,2016,71.3,2
254,1962,100,2001,74.7,39
254,2002,74.9,2004,72.3,2
254,2006,72.6,2008,72.3,2
254,2008,72.3,2010,70.4,2
254,2010,70.4,2012,70.2,2
254,2012,70.2,2014,68.8,2
254,2014,68.8,2016,68.6,2
255,1962,100,2001,74.8,39
255,2001,74.8,2002,74.8,1
255,2002,74.8,2004,73.3,2
255,2004,73.3,2006,72.8,2
255,2006,72.8,2008,72.1,2
255,2010,72.2,2012,71.4,2
255,2012,71.4,2014,70.6,2
255,2014,70.6,2016,70.4,2
256,1962,100,2001,75,39
256,2001,75,2002,75,1
256,2002,75,2004,75,2
256,2004,75,2006,74.4,2
256,2006,74.4,2008,74.1,2
256,2008,74.1,2010,73.6,2
256,2010,73.6,2012,73.1,2
256,2012,73.1,2014,72.6,2
256,2014,72.6,2016,72.3,2
257,1962,100,2001,74.7,39
257,2001,74.7,2002,74.7,1
257,2002,74.7,2004,73.1,2
257,2006,73.3,2008,73.2,2
257,2008,73.2,2010,72.7,2
257,2010,72.7,2012,72.2,2
257,2012,72.2,2014,70.9,2
257,2014,70.9,2016,70.2,2
258,1964,100,2001,96.7,37
258,2001,96.7,2002,73.6,1
258,2002,73.6,2004,73.6,2
258,2006,74.4,2008,72.3,2
258,2008,72.3,2010,70.9,2
258,2010,70.9,2012,69.9,2
258,2012,69.9,2014,68.5,2
258,2014,68.5,2016,67.7,2
259,1964,100,2005,75,41
259,2005,75,2006,72,1
259,2006,72,2008,70.4,2
259,2008,70.4,2010,69.3,2
259,2010,69.3,2012,68.5,2
259,2012,68.5,2014,67.5,2
259,2014,67.5,2016,66.1,2
260,1977,100,2001,67.7,24
260,2002,93.3,2004,67.5,2
260,2005,72.6,2007,72.2,2
260,2009,73.6,2011,72.2,2
260,2011,72.2,2013,71.4,2
260,2013,71.4,2015,69.6,2
260,2015,69.6,2017,69.5,2
261,1938,100,2001,65.7,63
261,2004,71.5,2005,70.9,1
261,2005,70.9,2007,67.7,2
261,2011,71.2,2013,70.1,2
261,2013,70.1,2015,69.4,2
262,1981,100,2001,67.7,20
262,2002,94.1,2004,89.5,2
262,2004,89.5,2005,73,1
262,2005,73,2007,72.7,2
262,2009,74.4,2011,74.2,2
262,2011,74.2,2013,74,2
262,2013,74,2015,73.8,2
262,2015,73.8,2017,73.6,2
263,1975,100,2001,67.7,26
263,2002,69,2004,69,2
263,2007,74.6,2009,74.5,2
263,2009,74.5,2011,73.5,2
263,2011,73.5,2013,73.5,2
263,2013,73.5,2015,72.9,2
263,2015,72.9,2017,72.5,2
264,1975,100,2001,67.9,26
264,2002,95.2,2004,70.5,2
264,2007,75,2009,74.3,2
264,2009,74.3,2011,72.7,2
264,2011,72.7,2013,72.3,2
264,2013,72.3,2015,69.8,2
264,2015,69.8,2017,69.3,2
265,1975,100,2001,67.9,26
265,2002,92.3,2004,63.6,2
265,2007,75,2009,70.3,2
265,2009,70.3,2011,65.5,2
265,2011,65.5,2013,64.6,2
265,2013,64.6,2015,62.4,2
265,2015,62.4,2017,62.2,2
266,1975,100,2001,67.6,26
266,2002,93,2004,67.6,2
266,2009,85.6,2011,85,2
266,2011,85,2013,83.6,2
266,2013,83.6,2015,81.1,2
266,2015,81.1,2017,77.6,2
267,1975,100,2001,66.4,26
267,2002,93.6,2004,70.9,2
267,2004,70.9,2005,70.5,1
267,2007,75,2009,69.3,2
267,2009,69.3,2011,67.1,2
267,2011,67.1,2013,66.7,2
267,2013,66.7,2015,64.5,2
267,2015,64.5,2017,64.2,2
268,1975,100,2001,67.8,26
268,2002,92.5,2004,67,2
268,2004,67,2005,67,1
268,2005,67,2007,66.9,2
268,2009,73.3,2011,72.7,2
268,2011,72.7,2013,72.5,2
268,2013,72.5,2015,72.1,2
269,1975,100,2001,68,26
269,2002,95.8,2004,69.1,2
269,2004,69.1,2005,68.9,1
269,2005,68.9,2007,67.7,2
269,2009,71.1,2011,69.8,2
269,2011,69.8,2013,69.2,2
269,2013,69.2,2015,68.2,2
269,2015,68.2,2017,68.2,2
270,1964,100,2001,67.8,37
270,2002,83.2,2004,57.9,2
270,2005,59.4,2007,59.2,2
270,2011,63.8,2013,63.5,2
270,2013,63.5,2015,62.5,2
270,2015,62.5,2017,62.3,2
271,1976,100,2001,65.8,25
271,2002,68.4,2004,67.8,2
271,2005,69.2,2007,68.6,2
271,2007,68.6,2009,65.2,2
271,2009,65.2,2011,61.8,2
271,2011,61.8,2013,60.6,2
271,2013,60.6,2015,58.2,2
272,1976,100,2001,63.9,25
272,2004,69.6,2005,67.3,1
272,2005,67.3,2007,66.7,2
272,2007,66.7,2009,66.7,2
272,2009,66.7,2011,63.1,2
272,2011,63.1,2013,62.5,2
272,2013,62.5,2015,59.6,2
273,1976,100,2001,59,25
273,2004,61.5,2005,61.5,1
273,2005,61.5,2007,60.9,2
273,2009,69.4,2011,67.2,2
273,2011,67.2,2013,66.5,2
273,2013,66.5,2015,65.5,2
274,1976,100,2001,67.8,25
274,2002,93.4,2004,75,2
274,2005,75.3,2007,73.9,2
274,2009,75,2011,73.2,2
274,2011,73.2,2013,72.9,2
274,2013,72.9,2015,72.4,2
274,2015,72.4,2017,71.6,2
275,1976,100,2001,67.5,25
275,2002,91.1,2004,68.5,2
275,2005,69.4,2007,68.9,2
275,2011,72.7,2013,72.5,2
275,2013,72.5,2015,71.9,2
276,1976,100,2001,67.4,25
276,2004,74.8,2005,73.8,1
276,2005,73.8,2007,71.2,2
276,2007,71.2,2009,70.5,2
276,2011,71.4,2013,71.2,2
276,2013,71.2,2015,69.7,2
277,1976,100,2001,68,25
277,2002,96.8,2004,78.7,2
277,2004,78.7,2005,78.7,1
277,2005,78.7,2007,74.3,2
277,2007,74.3,2009,72.3,2
277,2009,72.3,2011,71.2,2
277,2011,71.2,2013,70.7,2
277,2013,70.7,2015,70,2
277,2015,70,2017,69.7,2
278,1976,100,2001,68,25
278,2002,96.8,2004,75,2
278,2004,75,2005,75,1
278,2005,75,2007,73.9,2
278,2009,76.5,2011,72.9,2
278,2011,72.9,2013,72.6,2
278,2013,72.6,2015,71.8,2
278,2015,71.8,2017,71.8,2
279,1976,100,2001,67.8,25
279,2002,95.6,2004,74.6,2
279,2005,76.4,2007,74.1,2
279,2009,74.2,2011,73.9,2
279,2011,73.9,2013,73.2,2
279,2013,73.2,2015,72.7,2
279,2015,72.7,2017,72.7,2
280,1976,100,2001,68,25
280,2002,97.9,2004,74.7,2
280,2004,74.7,2005,74.7,1
280,2007,75.8,2009,74.8,2
280,2009,74.8,2011,73.9,2
280,2011,73.9,2013,73.9,2
280,2013,73.9,2015,73.3,2
280,2015,73.3,2017,73,2
281,1976,100,2001,68,25
281,2002,97.9,2004,72.5,2
281,2004,72.5,2005,72.5,1
281,2007,75.9,2009,75.5,2
281,2009,75.5,2011,74.7,2
281,2011,74.7,2013,74.4,2
281,2013,74.4,2015,73.7,2
281,2015,73.7,2017,73,2
282,1976,100,2001,68,25
282,2002,95,2004,75.7,2
282,2004,75.7,2005,73.2,1
282,2007,75.8,2009,74.7,2
282,2009,74.7,2011,73.3,2
282,2011,73.3,2013,73,2
282,2013,73,2015,72.6,2
282,2015,72.6,2017,72.3,2
283,1976,100,2001,68,25
283,2002,98.1,2004,72.1,2
283,2004,72.1,2005,72.1,1
283,2007,75,2009,74.1,2
283,2009,74.1,2011,73.2,2
283,2011,73.2,2013,73,2
283,2013,73,2015,72.2,2
283,2015,72.2,2017,72,2
284,1976,100,2001,68,25
284,2002,95.5,2004,71.7,2
284,2004,71.7,2005,71.7,1
284,2007,75,2009,73.7,2
284,2009,73.7,2011,73.5,2
284,2011,73.5,2013,73.1,2
284,2013,73.1,2015,73.1,2
284,2015,73.1,2017,72.9,2
285,1972,100,2001,68,29
285,2002,95.7,2004,73.7,2
285,2004,73.7,2005,72.7,1
285,2007,75.6,2009,73.6,2
285,2009,73.6,2011,72.7,2
285,2011,72.7,2013,71.9,2
285,2013,71.9,2015,70.6,2
285,2015,70.6,2017,70.4,2
286,1972,100,2001,68,29
286,2002,96.3,2004,74.2,2
286,2004,74.2,2005,73.2,1
286,2007,75.6,2009,74.1,2
286,2009,74.1,2011,73.6,2
286,2011,73.6,2013,72.6,2
286,2013,72.6,2015,71.9,2
286,2015,71.9,2017,71.7,2
287,1972,100,2001,68,29
287,2002,94.4,2004,71.6,2
287,2004,71.6,2005,71.6,1
287,2007,75.7,2009,74,2
287,2009,74,2011,73.3,2
287,2011,73.3,2013,72.7,2
287,2013,72.7,2015,71.7,2
287,2015,71.7,2017,71.5,2
288,1972,100,2001,68,29
288,2002,94.9,2004,72.2,2
288,2004,72.2,2005,72.2,1
288,2007,75.7,2009,73.8,2
288,2009,73.8,2011,73.2,2
288,2011,73.2,2013,72.4,2
288,2013,72.4,2015,72.3,2
288,2015,72.3,2017,71.5,2
289,1972,100,2001,68,29
289,2002,94.8,2004,68.2,2
289,2005,70.5,2007,69.6,2
289,2009,70.8,2011,69.4,2
289,2011,69.4,2013,67.6,2
289,2013,67.6,2015,66.8,2
289,2015,66.8,2017,66.3,2
290,1972,100,2001,68,29
290,2002,94.9,2004,67.8,2
290,2005,69.7,2007,69.6,2
290,2009,70.8,2011,69.6,2
290,2011,69.6,2013,67.4,2
290,2013,67.4,2015,66.6,2
290,2015,66.6,2017,66.6,2
291,1976,100,2001,68,25
291,2002,95,2004,95,2
291,2004,95,2005,75,1
291,2005,75,2007,75,2
291,2007,75,2009,75,2
291,2009,75,2011,75,2
291,2013,75.4,2015,75.1,2
291,2015,75.1,2017,74.7,2
292,1976,100,2001,68,25
292,2002,95,2004,95,2
292,2004,95,2005,75,1
292,2005,75,2007,75,2
292,2007,75,2009,75,2
292,2009,75,2011,75,2
292,2013,75.4,2015,75.1,2
292,2015,75.1,2017,74.5,2
293,1972,100,2001,68,29
293,2002,92.1,2004,75,2
293,2004,75,2005,74.2,1
293,2005,74.2,2007,73.3,2
293,2007,73.3,2009,73,2
293,2009,73,2011,72.9,2
293,2011,72.9,2013,72.3,2
293,2013,72.3,2015,71.5,2
293,2015,71.5,2017,70.8,2
294,1972,100,2001,68,29
294,2002,91.8,2004,75,2
294,2004,75,2005,75,1
294,2005,75,2007,73.3,2
294,2007,73.3,2009,72.6,2
294,2009,72.6,2011,72.4,2
294,2011,72.4,2013,71.7,2
294,2013,71.7,2015,71.3,2
294,2015,71.3,2017,70.3,2
295,1976,100,2001,68,25
295,2002,94.8,2004,73.6,2
295,2004,73.6,2005,73.4,1
295,2005,73.4,2007,72.4,2
295,2009,73.7,2011,72.7,2
295,2011,72.7,2013,72.1,2
295,2013,72.1,2015,70.7,2
295,2015,70.7,2017,70.6,2
296,1976,100,2001,68,25
296,2002,94.8,2004,75.8,2
296,2004,75.8,2005,75.8,1
296,2005,75.8,2007,74.5,2
296,2007,74.5,2009,74.3,2
296,2009,74.3,2011,73.8,2
296,2013,73.9,2015,73.2,2
296,2015,73.2,2017,72.9,2
297,1976,100,2001,68,25
297,2002,95,2004,75,2
297,2004,75,2005,75,1
297,2005,75,2007,74,2
297,2007,74,2009,73.7,2
297,2009,73.7,2011,72.6,2
297,2011,72.6,2013,72.6,2
297,2013,72.6,2015,71.8,2
297,2015,71.8,2017,71.5,2
298,1976,100,2001,68.1,25
298,2002,95,2004,75,2
298,2004,75,2005,75,1
298,2005,75,2007,73.7,2
298,2009,73.9,2011,72.1,2
298,2011,72.1,2013,71.7,2
298,2013,71.7,2015,70.8,2
298,2015,70.8,2017,70.2,2
299,1976,100,2001,68,25
299,2002,95.1,2004,70.5,2
299,2004,70.5,2005,70.5,1
299,2005,70.5,2007,69.8,2
299,2009,72,2011,69.9,2
299,2011,69.9,2013,69.5,2
299,2013,69.5,2015,67.8,2
299,2015,67.8,2017,67.1,2
300,1976,100,2001,68,25
300,2002,93.8,2004,71.6,2
300,2004,71.6,2005,71.6,1
300,2005,71.6,2007,70.2,2
300,2009,70.3,2011,68.6,2
300,2011,68.6,2013,68.5,2
300,2013,68.5,2015,68.2,2
300,2015,68.2,2017,68.1,2
301,1976,100,2001,68,25
301,2002,94.7,2004,75,2
301,2004,75,2005,75,1
301,2005,75,2007,74.3,2
301,2009,74.6,2011,74.2,2
301,2013,74.5,2015,74.4,2
301,2015,74.4,2017,74.2,2
302,1976,100,2001,68,25
302,2002,94.7,2004,75,2
302,2004,75,2005,75,1
302,2005,75,2007,74.9,2
302,2007,74.9,2009,74.8,2
302,2009,74.8,2011,74.6,2
302,2013,75.2,2015,74.9,2
302,2015,74.9,2017,74.7,2
303,1958,100,2001,97,43
303,2001,97,2003,74.9,2
303,2005,84.4,2007,74.7,2
303,2009,75,2011,75,2
303,2011,75,2013,74.5,2
303,2013,74.5,2015,74.5,2
303,2015,74.5,2017,74,2
304,1957,100,2001,70,44
304,2001,70,2003,65,2
304,2005,69.9,2007,69.9,2
304,2007,69.9,2009,66.1,2
304,2009,66.1,2011,63,2
304,2013,63.3,2015,62.2,2
304,2015,62.2,2017,62.2,2
305,2009,100,2013,92.9,4
305,2013,92.9,2015,89.2,2
305,2015,89.2,2017,85.8,2
306,2007,100,2015,92,8
307,2007,100,2015,92,8
308,2007,100,2015,92,8
309,1938,100,2006,65.9,68
309,2010,69.6,2014,66.5,4
310,1938,100,2006,64.5,68
310,2006,64.5,2008,62.7,2
310,2012,73.2,2016,72.2,4
311,1967,100,2001,75,34
311,2001,75,2003,75,2
311,2003,75,2005,74.7,2
311,2005,74.7,2007,74.7,2
311,2007,74.7,2009,74.4,2
311,2009,74.4,2011,73.9,2
311,2011,73.9,2013,72.5,2
311,2013,72.5,2015,72.3,2
312,1968,100,2001,71.6,33
312,2001,71.6,2003,71.6,2
312,2005,74.3,2007,74.3,2
312,2007,74.3,2009,74,2
312,2009,74,2011,71.1,2
312,2011,71.1,2013,70.9,2
312,2013,70.9,2015,70.7,2
312,2015,70.7,2017,70.7,2
313,1998,100,2001,90.6,3
313,2001,90.6,2003,90.1,2
313,2003,90.1,2005,88.3,2
313,2005,88.3,2007,84.4,2
313,2007,84.4,2009,74.6,2
313,2009,74.6,2011,74.5,2
313,2011,74.5,2013,73.7,2
313,2013,73.7,2015,73.7,2
314,1997,100,2001,99,4
314,2001,99,2003,92.2,2
314,2003,92.2,2005,89.6,2
314,2005,89.6,2007,87.2,2
314,2007,87.2,2009,82.4,2
314,2009,82.4,2011,78.4,2
314,2011,78.4,2013,77.9,2
314,2013,77.9,2015,77.5,2
314,2015,77.5,2017,77.5,2
315,1997,100,2007,74.6,10
315,2010,74.8,2014,74.8,4
316,1997,100,2006,73.4,9
316,2010,74.9,2014,74.6,4
317,1938,100,2006,54.2,68
317,2008,68.5,2010,64.4,2
317,2010,64.4,2012,63,2
317,2012,63,2014,62.9,2
317,2014,62.9,2016,61.9,2
318,1998,100,2006,96.3,8
318,2006,96.3,2008,73.8,2
318,2008,73.8,2010,73.5,2
318,2010,73.5,2012,71.1,2
318,2014,79.6,2016,77.7,2
319,1998,100,2007,74.6,9
319,2007,74.6,2010,74.6,3
319,2010,74.6,2014,74.1,4
320,2001,100,2006,74.4,5
320,2010,84.1,2014,80.9,4
321,1965,100,2007,75,42
321,2007,75,2011,70.3,4
322,2004,100,2006,75,2
322,2006,75,2010,74.6,4
322,2010,74.6,2014,74.6,4
323,2004,100,2006,75,2
323,2006,75,2010,74.7,4
323,2010,74.7,2014,74.7,4
324,1999,100,2001,98.7,2
324,2001,98.7,2003,96,2
324,2003,96,2005,90.4,2
324,2005,90.4,2007,86.7,2
324,2007,86.7,2009,84.7,2
324,2009,84.7,2011,82.6,2
324,2013,83.7,2015,81.8,2
324,2015,81.8,2017,81,2
325,1999,100,2001,99.9,2
325,2001,99.9,2003,94.2,2
325,2003,94.2,2005,89.1,2
325,2005,89.1,2007,84.9,2
325,2007,84.9,2009,76.7,2
325,2009,76.7,2011,76.3,2
325,2011,76.3,2013,75.3,2
325,2013,75.3,2015,75.2,2
325,2015,75.2,2017,74.8,2
326,1999,100,2001,99.8,2
326,2001,99.8,2003,95.9,2
326,2003,95.9,2005,89.6,2
326,2005,89.6,2007,83.4,2
326,2007,83.4,2009,75.4,2
326,2009,75.4,2011,75.2,2
326,2011,75.2,2013,75.1,2
326,2013,75.1,2015,75,2
326,2015,75,2017,74.9,2
327,1994,100,2001,95.9,7
327,2001,95.9,2003,91.2,2
327,2003,91.2,2005,88.1,2
327,2005,88.1,2007,78.1,2
327,2007,78.1,2009,76.1,2
327,2009,76.1,2011,75.2,2
327,2013,75.4,2015,73.7,2
327,2015,73.7,2017,73.2,2
328,1994,100,2001,96,7
328,2001,96,2003,90.7,2
328,2003,90.7,2005,88.2,2
328,2005,88.2,2007,78,2
328,2007,78,2009,75.3,2
328,2009,75.3,2011,74.7,2
328,2013,75.5,2015,75.2,2
328,2015,75.2,2017,73.4,2
329,1992,100,2001,97.9,9
329,2001,97.9,2003,93.6,2
329,2003,93.6,2005,91.1,2
329,2005,91.1,2007,86.7,2
329,2007,86.7,2009,82.8,2
329,2009,82.8,2011,81,2
329,2013,82.7,2015,76.1,2
329,2015,76.1,2017,75.8,2
330,1998,100,2001,93.7,3
330,2001,93.7,2003,92.8,2
330,2003,92.8,2005,89.3,2
330,2005,89.3,2007,86.5,2
330,2007,86.5,2009,82.5,2
330,2009,82.5,2011,80.9,2
330,2011,80.9,2013,80.3,2
330,2013,80.3,2015,79,2
330,2015,79,2017,77.4,2
331,1998,100,2001,93.8,3
331,2001,93.8,2003,92.7,2
331,2003,92.7,2005,89.2,2
331,2005,89.2,2007,84.1,2
331,2007,84.1,2009,80.5,2
331,2009,80.5,2011,79,2
331,2011,79,2013,77.4,2
331,2013,77.4,2015,76.5,2
331,2015,76.5,2017,75,2
332,1998,100,2001,77.6,3
332,2003,93.5,2005,89.9,2
332,2005,89.9,2007,84.3,2
332,2007,84.3,2009,82.8,2
332,2009,82.8,2011,79.7,2
332,2013,81,2015,79.7,2
332,2015,79.7,2017,78.2,2
333,1997,100,2001,87.7,4
333,2003,90.7,2005,88.6,2
333,2005,88.6,2007,85.9,2
333,2007,85.9,2009,83.2,2
333,2009,83.2,2011,79,2
333,2011,79,2013,76.4,2
333,2013,76.4,2015,75,2
333,2015,75,2017,74.9,2
334,1997,100,2001,93.5,4
334,2001,93.5,2003,91.9,2
334,2003,91.9,2005,89.3,2
334,2005,89.3,2007,84.2,2
334,2007,84.2,2009,75.5,2
334,2009,75.5,2011,75.2,2
334,2011,75.2,2013,75,2
334,2013,75,2015,74.7,2
334,2015,74.7,2017,74.6,2
335,1997,100,2001,99,4
335,2001,99,2003,91.9,2
335,2003,91.9,2005,89.5,2
335,2005,89.5,2007,85.7,2
335,2007,85.7,2009,78.2,2
335,2009,78.2,2011,77.5,2
335,2011,77.5,2013,77.1,2
335,2013,77.1,2015,76.7,2
335,2015,76.7,2017,74.8,2
336,1997,100,2001,97.3,4
336,2001,97.3,2003,90.9,2
336,2003,90.9,2005,88.4,2
336,2005,88.4,2007,84.7,2
336,2007,84.7,2009,77.3,2
336,2009,77.3,2011,76.1,2
336,2011,76.1,2013,75.7,2
336,2013,75.7,2015,75.5,2
336,2015,75.5,2017,74.5,2
337,1997,100,2001,97.5,4
337,2001,97.5,2003,89.6,2
337,2003,89.6,2005,88.6,2
337,2005,88.6,2007,85.9,2
337,2007,85.9,2009,85.5,2
337,2009,85.5,2011,83.2,2
337,2011,83.2,2013,81.3,2
337,2013,81.3,2015,81.2,2
337,2015,81.2,2017,80.8,2
338,1965,100,2007,72,42
338,2007,72,2011,70.1,4
338,2011,70.1,2015,66.7,4
339,1938,100,2003,63.3,65
339,2005,69.8,2007,66.5,2
339,2007,66.5,2009,64.3,2
339,2011,71.8,2013,70.8,2
339,2013,70.8,2015,69.9,2
340,1995,100,2007,71.5,12
340,2007,71.5,2011,71.5,4
340,2011,71.5,2015,71.5,4
341,1991,100,2001,77.9,10
341,2001,77.9,2003,77.9,2
341,2003,77.9,2005,74.9,2
341,2005,74.9,2007,74.8,2
341,2007,74.8,2009,74.7,2
341,2009,74.7,2011,74.6,2
341,2011,74.6,2013,74.4,2
341,2013,74.4,2015,74.2,2
341,2015,74.2,2017,73.9,2
342,1991,100,2001,88.5,10
342,2003,91.1,2005,75,2
342,2005,75,2007,74.8,2
342,2007,74.8,2009,74.8,2
342,2009,74.8,2011,74.8,2
342,2011,74.8,2013,74.6,2
342,2013,74.6,2015,74.4,2
342,2015,74.4,2017,73.5,2
343,1960,100,2006,67.7,46
343,2006,67.7,2010,66.8,4
344,1965,100,2007,75,42
344,2007,75,2008,72.4,1
344,2008,72.4,2009,72.4,1
344,2010,74.7,2012,74.7,2
344,2012,74.7,2014,74.2,2
344,2014,74.2,2016,73.8,2
345,1979,100,2001,87.7,22
345,2001,87.7,2004,87.7,3
345,2004,87.7,2006,77.8,2
345,2006,77.8,2007,72.7,1
345,2007,72.7,2009,71.2,2
345,2011,71.8,2013,71.5,2
345,2013,71.5,2015,69.8,2
345,2015,69.8,2017,69.8,2
346,1972,100,2003,84.6,31
346,2003,84.6,2005,73.6,2
346,2006,73.9,2008,73.2,2
346,2008,73.2,2010,73,2
346,2010,73,2012,73,2
346,2012,73,2014,72.9,2
346,2014,72.9,2016,72.6,2
347,1972,100,2003,92.9,31
347,2003,92.9,2005,74.5,2
347,2005,74.5,2006,74.3,1
347,2006,74.3,2008,74.3,2
347,2008,74.3,2010,73.5,2
347,2012,74.1,2014,73.5,2
347,2014,73.5,2016,73.4,2
348,1971,100,2003,93.3,32
348,2003,93.3,2005,74.8,2
348,2005,74.8,2006,74.8,1
348,2006,74.8,2008,74.7,2
348,2008,74.7,2010,74.4,2
348,2012,74.9,2014,74.9,2
348,2014,74.9,2016,74.6,2
349,1982,100,2000,95.1,18
349,2000,95.1,2006,74.5,6
349,2006,74.5,2007,74.5,1
349,2009,74.6,2011,74.2,2
349,2011,74.2,2013,74.1,2
349,2015,74.5,2017,74.5,2
350,1982,100,2006,75,24
350,2006,75,2007,74.8,1
350,2009,75.3,2011,74.6,2
350,2011,74.6,2013,74.5,2
350,2015,75,2017,74.9,2
351,1981,100,2005,74.8,24
351,2005,74.8,2007,74.5,2
351,2007,74.5,2009,74,2
351,2011,74.4,2013,74.3,2
351,2013,74.3,2015,74,2
351,2015,74,2017,73.9,2
352,1981,100,2001,97.1,20
352,2001,97.1,2004,97.1,3
352,2004,97.1,2006,73.9,2
352,2007,74.3,2009,73.3,2
352,2009,73.3,2011,72.5,2
352,2011,72.5,2013,72.2,2
352,2013,72.2,2015,71.1,2
353,1974,100,2005,75,31
353,2005,75,2007,74.5,2
353,2009,75,2011,74.9,2
353,2011,74.9,2013,74.9,2
353,2013,74.9,2015,74.9,2
353,2015,74.9,2017,74.8,2
354,1970,100,2007,78.4,37
354,2007,78.4,2009,76.5,2
354,2011,77.4,2013,77.3,2
354,2013,77.3,2015,76.1,2
355,1994,100,2007,81.4,13
355,2007,81.4,2009,73.6,2
355,2009,73.6,2011,73,2
355,2011,73,2013,73,2
355,2015,74.2,2017,74.1,2
356,1995,100,2007,96,12
356,2007,96,2011,89.2,4
356,2013,91.1,2015,88.7,2
356,2015,88.7,2017,86.7,2
357,1995,100,2007,70.7,12
357,2007,70.7,2009,69.9,2
357,2013,72.8,2015,72.8,2
357,2015,72.8,2017,72.6,2
358,1996,100,2007,74.9,11
358,2007,74.9,2009,74.1,2
358,2009,74.1,2011,73.4,2
358,2013,74.3,2015,73.9,2
358,2015,73.9,2017,73.8,2
359,1996,100,2007,94.1,11
359,2007,94.1,2011,89.8,4
359,2013,91,2015,89.1,2
359,2015,89.1,2017,87.8,2
360,1996,100,2007,74.7,11
360,2007,74.7,2009,74.2,2
360,2009,74.2,2011,73.2,2
360,2013,73.9,2015,73.5,2
360,2015,73.5,2017,73.4,2
361,1995,100,2001,74.4,6
361,2003,96.6,2005,92.2,2
361,2006,96.2,2007,95.6,1
361,2007,95.6,2008,94.5,1
361,2008,94.5,2010,94.3,2
361,2010,94.3,2012,93.3,2
361,2012,93.3,2014,84,2
362,1978,100,2001,67.6,23
362,2003,92.5,2005,73.3,2
362,2005,73.3,2007,71.6,2
362,2007,71.6,2009,71.5,2
362,2009,71.5,2011,71.5,2
362,2013,72.8,2015,72.2,2
362,2015,72.2,2017,72,2
363,1978,100,2001,67.9,23
363,2003,93,2005,73,2
363,2005,73,2007,71.9,2
363,2009,72.1,2011,71.8,2
363,2013,72.5,2015,72.4,2
363,2015,72.4,2017,72.1,2
364,1978,100,2001,67.1,23
364,2003,80.1,2005,70.4,2
364,2005,70.4,2007,69.5,2
364,2009,71,2011,70.7,2
364,2011,70.7,2013,70.1,2
364,2015,71.2,2017,70,2
365,1979,100,2001,67.6,22
365,2003,91.8,2005,72.5,2
365,2005,72.5,2007,72.2,2
365,2009,72.3,2011,71.7,2
365,2011,71.7,2013,71.1,2
365,2013,71.1,2015,70.9,2
365,2015,70.9,2017,70.8,2
366,1979,100,2001,67.9,22
366,2003,91.3,2005,72.5,2
366,2005,72.5,2007,72.4,2
366,2007,72.4,2009,72.1,2
366,2009,72.1,2011,71.6,2
366,2011,71.6,2013,70.7,2
366,2013,70.7,2015,70.7,2
366,2015,70.7,2017,70.6,2
367,1979,100,2001,67,22
367,2003,93.4,2005,74.5,2
367,2005,74.5,2007,74.1,2
367,2007,74.1,2009,74.1,2
367,2009,74.1,2011,74,2
367,2011,74,2013,73.5,2
367,2013,73.5,2015,72.7,2
368,1979,100,2001,67.2,22
368,2003,92.7,2005,74.5,2
368,2005,74.5,2007,74.1,2
368,2011,74.5,2013,74.2,2
368,2013,74.2,2015,73.5,2
369,1981,100,2001,67,20
369,2003,91.6,2005,73.8,2
369,2005,73.8,2007,73.5,2
369,2007,73.5,2009,73.5,2
369,2009,73.5,2011,73,2
369,2011,73,2013,71.7,2
369,2013,71.7,2015,71.2,2
369,2015,71.2,2017,71.1,2
370,1981,100,2001,67.5,20
370,2003,91.8,2005,74,2
370,2005,74,2007,73.3,2
370,2009,73.5,2011,72.9,2
370,2011,72.9,2013,72.4,2
370,2013,72.4,2015,72.2,2
371,1981,100,2001,67.4,20
371,2003,91.1,2005,74.7,2
371,2005,74.7,2007,74.3,2
371,2009,74.6,2011,74.5,2
371,2011,74.5,2013,73.9,2
371,2013,73.9,2015,73.2,2
372,1981,100,2001,67.4,20
372,2003,91.7,2005,74,2
372,2005,74,2007,73.2,2
372,2009,73.5,2011,73.4,2
372,2011,73.4,2013,72.5,2
372,2013,72.5,2015,72.5,2
372,2015,72.5,2017,72.5,2
373,1980,100,2007,74.7,27
373,2007,74.7,2009,73.8,2
373,2011,73.9,2013,73.1,2
373,2013,73.1,2015,73.1,2
373,2015,73.1,2017,72.7,2
374,1981,100,2001,67.1,20
374,2003,90.9,2005,74.1,2
374,2005,74.1,2007,73.4,2
374,2009,73.5,2011,73,2
374,2013,73.4,2015,72.8,2
374,2015,72.8,2017,72.7,2
375,1979,100,2001,68,22
375,2003,95,2005,74.3,2
375,2005,74.3,2007,74.3,2
375,2009,74.8,2011,74.6,2
375,2011,74.6,2013,74.4,2
375,2013,74.4,2015,74.3,2
375,2015,74.3,2017,74.1,2
376,1976,100,2001,68,25
376,2003,95,2005,71.1,2
376,2005,71.1,2006,71.1,1
376,2006,71.1,2007,71,1
376,2008,71.2,2010,70.5,2
376,2010,70.5,2012,70.5,2
376,2012,70.5,2014,70.1,2
377,1976,100,2001,68,25
377,2003,95,2005,73.8,2
377,2005,73.8,2006,73.5,1
377,2006,73.5,2007,71.9,1
377,2007,71.9,2008,71.9,1
377,2008,71.9,2010,70.2,2
377,2010,70.2,2012,69.7,2
377,2012,69.7,2014,69.4,2
378,1976,100,2001,65.7,25
378,2003,69.7,2005,64.1,2
378,2005,64.1,2007,63.5,2
378,2008,67.2,2010,66.8,2
378,2010,66.8,2012,66.7,2
378,2012,66.7,2014,66.5,2
378,2014,66.5,2016,65.2,2
379,1976,100,2001,66,25
379,2003,80.6,2005,56.9,2
379,2008,69.1,2010,67.9,2
379,2010,67.9,2012,66.5,2
379,2012,66.5,2014,65.1,2
379,2014,65.1,2016,63.3,2
380,1976,100,2001,68,25
380,2003,95,2005,75,2
380,2005,75,2007,73.6,2
380,2009,73.9,2011,73.3,2
380,2011,73.3,2013,73,2
380,2013,73,2015,72.5,2
380,2015,72.5,2017,71.8,2
381,1976,100,2001,68,25
381,2003,95,2005,74,2
381,2005,74,2007,72.8,2
381,2007,72.8,2009,72.8,2
381,2009,72.8,2011,70.4,2
381,2011,70.4,2013,70.3,2
381,2013,70.3,2015,70,2
381,2015,70,2017,69.8,2
382,1976,100,2001,68,25
382,2003,95,2005,73.3,2
382,2005,73.3,2007,73,2
382,2007,73,2009,73,2
382,2009,73,2011,70.3,2
382,2011,70.3,2013,70.1,2
382,2013,70.1,2015,69.4,2
383,1976,100,2001,68,25
383,2003,95,2005,70.8,2
383,2005,70.8,2007,68.5,2
383,2009,71.7,2011,68.6,2
383,2013,68.7,2015,67.7,2
384,1976,100,2001,68,25
384,2003,95,2005,67.6,2
384,2005,67.6,2007,67,2
384,2009,70,2011,69.7,2
384,2011,69.7,2013,69.7,2
384,2013,69.7,2015,68.6,2
385,1976,100,2001,68,25
385,2003,95,2005,70.4,2
385,2005,70.4,2007,70.1,2
385,2009,71.3,2011,70.6,2
385,2011,70.6,2013,70.6,2
385,2013,70.6,2015,69.4,2
386,1976,100,2001,68,25
386,2003,95,2005,67.7,2
386,2005,67.7,2007,67.1,2
386,2009,73.3,2011,71.6,2
386,2011,71.6,2013,70.3,2
386,2013,70.3,2015,69.7,2
387,1976,100,2001,68,25
387,2003,95,2005,75,2
387,2005,75,2007,73.1,2
387,2009,74.1,2011,73.5,2
387,2013,73.7,2015,72.7,2
388,1980,100,2001,64.5,21
388,2003,94.5,2005,72.7,2
388,2005,72.7,2007,72.1,2
388,2007,72.1,2009,71,2
388,2009,71,2011,62.9,2
388,2011,62.9,2013,62.5,2
388,2013,62.5,2015,62.2,2
389,1980,100,2001,68,21
389,2003,95,2005,73.2,2
389,2007,76.4,2009,75,2
389,2009,75,2011,73.8,2
389,2011,73.8,2013,73.7,2
389,2013,73.7,2015,73.1,2
389,2015,73.1,2017,73,2
390,1978,100,2001,68,23
390,2005,74.5,2007,74.5,2
390,2007,74.5,2009,73.7,2
390,2009,73.7,2011,72.2,2
390,2011,72.2,2013,72.1,2
390,2013,72.1,2015,71.5,2
390,2015,71.5,2017,71.4,2
391,1978,100,2001,68,23
391,2001,68,2003,68,2
391,2003,68,2005,63.5,2
391,2009,70.7,2011,70.6,2
391,2013,70.7,2015,70.5,2
392,1977,100,2003,95,26
392,2003,95,2005,63.9,2
392,2007,73.3,2009,72.8,2
392,2009,72.8,2011,71.6,2
392,2013,71.7,2015,71,2
393,1977,100,2001,68,24
393,2003,95,2005,68.1,2
393,2007,71.6,2009,71.6,2
393,2009,71.6,2011,70.9,2
393,2011,70.9,2013,70.7,2
393,2013,70.7,2015,70.1,2
394,1980,100,2001,68,21
394,2003,95,2005,60.7,2
394,2007,61.9,2009,60.2,2
394,2011,61.8,2013,60.5,2
394,2013,60.5,2015,59.4,2
395,1987,100,2005,75,18
395,2005,75,2007,75,2
395,2007,75,2008,75,1
395,2008,75,2010,74.7,2
395,2010,74.7,2012,74.6,2
395,2012,74.6,2014,74.1,2
395,2014,74.1,2016,74.1,2
396,1998,100,2005,75,7
396,2005,75,2007,75,2
396,2009,97.2,2011,97.2,2
396,2011,97.2,2013,97,2
396,2013,97,2015,92.9,2
396,2015,92.9,2017,80.1,2
397,1978,100,2005,74.1,27
397,2005,74.1,2007,73.2,2
397,2009,73.3,2011,72.6,2
397,2011,72.6,2013,72.6,2
397,2013,72.6,2015,72.2,2
397,2015,72.2,2017,72,2
398,1978,100,2005,71.9,27
398,2005,71.9,2007,71.9,2
398,2007,71.9,2009,71.9,2
398,2009,71.9,2011,70.8,2
398,2013,70.9,2015,70.7,2
398,2015,70.7,2017,70.6,2
399,1931,100,2003,75,72
399,2003,75,2005,75,2
399,2005,75,2007,74.6,2
399,2007,74.6,2009,74.4,2
399,2009,74.4,2011,73.9,2
399,2013,74.7,2015,74,2
399,2015,74,2017,73.8,2
400,1923,100,2001,75,78
400,2001,75,2003,75,2
400,2003,75,2005,73.2,2
400,2005,73.2,2007,72.5,2
400,2007,72.5,2009,72.5,2
400,2009,72.5,2011,69.3,2
400,2011,69.3,2013,68.6,2
400,2013,68.6,2015,68,2
400,2015,68,2017,67.9,2
401,1976,100,2001,74.3,25
401,2001,74.3,2003,54.7,2
401,2003,54.7,2005,51.5,2
401,2005,51.5,2007,50,2
401,2009,71.5,2011,65.7,2
401,2011,65.7,2013,65.7,2
401,2015,67.4,2017,67,2
402,1976,100,2001,75,25
402,2001,75,2003,75,2
402,2003,75,2005,67.3,2
402,2005,67.3,2007,66.4,2
402,2009,72.4,2011,68.9,2
402,2011,68.9,2013,68.2,2
402,2015,73.6,2017,73.4,2
403,1976,100,2001,75,25
403,2001,75,2003,75,2
403,2003,75,2005,75,2
403,2005,75,2007,74.2,2
403,2007,74.2,2009,74.2,2
403,2009,74.2,2011,72.3,2
403,2013,75.3,2015,74.6,2
403,2015,74.6,2017,74.3,2
404,1956,100,2000,71.3,44
404,2000,71.3,2002,68.3,2
404,2002,68.3,2004,68.1,2
404,2004,68.1,2006,64.8,2
404,2006,64.8,2008,64.7,2
404,2010,70.3,2011,70.2,1
404,2013,70.5,2015,69.9,2
404,2015,69.9,2017,69.9,2
405,1961,100,2002,75,41
405,2002,75,2004,74.8,2
405,2004,74.8,2006,72.4,2
405,2006,72.4,2007,71.4,1
405,2009,73.9,2011,70.6,2
405,2013,73.1,2015,72.2,2
405,2015,72.2,2017,72.2,2
406,1961,100,2002,75,41
406,2002,75,2004,39.6,2
406,2006,66.8,2007,60,1
406,2009,70.2,2011,69.8,2
406,2013,73.5,2015,70.4,2
406,2015,70.4,2017,70.1,2
407,1962,100,2002,75,40
407,2002,75,2004,75,2
407,2004,75,2006,75,2
407,2006,75,2007,75,1
407,2007,75,2009,74.3,2
407,2009,74.3,2011,72.9,2
407,2013,73.6,2015,73.6,2
408,1965,100,2000,71.7,35
408,2000,71.7,2002,71.3,2
408,2004,72,2006,71.8,2
408,2008,72,2010,69.5,2
408,2014,78.7,2016,77.7,2
409,1956,100,2009,67.1,53
409,2009,67.1,2013,66.3,4
410,1958,100,2003,70.6,45
410,2008,73.6,2010,73,2
410,2010,73,2012,72.9,2
410,2012,72.9,2014,70,2
411,1958,100,2000,74.3,42
411,2004,75,2006,75,2
411,2006,75,2008,75,2
411,2008,75,2010,73.6,2
411,2010,73.6,2012,72.8,2
411,2012,72.8,2014,72.4,2
411,2014,72.4,2016,72.4,2
412,2004,100,2006,100,2
412,2006,100,2008,99.9,2
412,2008,99.9,2010,96.1,2
412,2010,96.1,2012,96.1,2
412,2012,96.1,2014,95.5,2
412,2014,95.5,2016,88.1,2
413,1958,100,2000,75,42
413,2000,75,2002,67.4,2
413,2002,67.4,2004,66.4,2
413,2004,66.4,2006,66.4,2
413,2010,73,2012,72,2
413,2012,72,2014,71.6,2
414,1958,100,2000,71.5,42
414,2000,71.5,2002,71.5,2
414,2002,71.5,2004,70.8,2
414,2004,70.8,2006,70.8,2
414,2006,70.8,2008,70.6,2
414,2008,70.6,2010,70.5,2
414,2010,70.5,2012,68.8,2
414,2012,68.8,2014,68,2
415,1985,100,2000,73.4,15
415,2000,73.4,2002,73.4,2
415,2004,74.9,2006,74.9,2
415,2006,74.9,2008,74.9,2
415,2008,74.9,2010,74.7,2
415,2010,74.7,2012,74.7,2
415,2012,74.7,2014,74.1,2
416,1991,100,2000,74.9,9
416,2000,74.9,2002,74.9,2
416,2002,74.9,2004,74.9,2
416,2004,74.9,2006,74.9,2
416,2008,78.1,2010,77.9,2
416,2010,77.9,2012,74.7,2
416,2012,74.7,2014,74.7,2
416,2014,74.7,2016,74.7,2
417,1990,100,2000,74.8,10
417,2000,74.8,2002,74.8,2
417,2006,75,2008,74.5,2
417,2008,74.5,2010,74.4,2
417,2014,74.6,2016,74.6,2
418,1992,100,2000,75,8
418,2000,75,2002,75,2
418,2002,75,2004,75,2
418,2004,75,2006,75,2
418,2006,75,2008,74.7,2
418,2008,74.7,2010,74.1,2
418,2012,74.9,2014,74.8,2
418,2014,74.8,2016,74.6,2
419,1992,100,2000,75,8
419,2000,75,2002,75,2
419,2002,75,2004,75,2
419,2004,75,2006,75,2
419,2006,75,2008,74.7,2
419,2008,74.7,2010,73.8,2
419,2012,74.9,2014,74.5,2
419,2014,74.5,2016,74.4,2
420,1991,100,2000,74.8,9
420,2000,74.8,2002,74.6,2
420,2002,74.6,2004,74.6,2
420,2006,74.9,2008,74.7,2
420,2008,74.7,2010,74.6,2
420,2010,74.6,2012,74.6,2
420,2014,74.7,2016,74.7,2
421,1990,100,2000,74.5,10
421,2000,74.5,2002,74.2,2
421,2004,74.8,2006,74.8,2
421,2008,77.9,2010,77.5,2
421,2010,77.5,2012,77.2,2
421,2012,77.2,2014,77.1,2
421,2014,77.1,2016,77,2
422,1990,100,2000,74.7,10
422,2004,74.9,2006,74.9,2
422,2006,74.9,2008,74.6,2
422,2008,74.6,2010,74.6,2
422,2010,74.6,2012,74.5,2
422,2012,74.5,2014,74.3,2
422,2014,74.3,2016,74.1,2
423,1959,100,2007,74,48
423,2007,74,2011,73.2,4
423,2011,73.2,2015,72.5,4
424,1959,100,2007,75,48
424,2007,75,2009,65.9,2
424,2013,66.6,2017,65.2,4
425,1958,100,2007,70.3,49
425,2011,72.8,2015,72.3,4
426,1958,100,2007,75,49
426,2007,75,2011,70.8,4
426,2011,70.8,2015,70.5,4
427,1958,100,2007,60.6,49
427,2007,60.6,2011,59.5,4
427,2011,59.5,2015,58.2,4
428,1958,100,2007,71.2,49
428,2007,71.2,2011,71.1,4
428,2011,71.1,2015,70.8,4
429,1958,100,2007,75,49
429,2007,75,2011,70.7,4
429,2011,70.7,2015,70.5,4
430,1958,100,2007,75,49
430,2007,75,2011,72.3,4
430,2011,72.3,2015,72,4
431,1958,100,2007,71.5,49
431,2007,71.5,2011,71.3,4
431,2011,71.3,2015,71.1,4
432,1958,100,2000,73.3,42
432,2000,73.3,2006,61.2,6
432,2010,67.6,2014,67.4,4
433,1957,100,2007,70.7,50
433,2007,70.7,2011,70.4,4
433,2011,70.4,2015,70.1,4
434,1957,100,2007,77.4,50
434,2007,77.4,2009,74.1,2
434,2009,74.1,2011,72,2
434,2013,74.1,2015,73.5,2
434,2015,73.5,2017,73.2,2
435,1957,100,2007,77.1,50
435,2007,77.1,2009,74.3,2
435,2009,74.3,2011,72,2
435,2013,72.6,2015,72.2,2
435,2015,72.2,2017,72.2,2
436,1983,100,2007,77.7,24
436,2007,77.7,2009,72.3,2
436,2009,72.3,2011,70.8,2
436,2011,70.8,2013,67,2
436,2013,67,2015,66.5,2
436,2015,66.5,2017,66.4,2
437,1985,100,2007,77.2,22
437,2007,77.2,2009,71.4,2
437,2009,71.4,2011,65.8,2
437,2013,67.1,2015,66.6,2
437,2015,66.6,2017,66.6,2
438,1957,100,2007,80.9,50
438,2007,80.9,2009,77.2,2
438,2009,77.2,2011,72.9,2
438,2013,74.2,2015,74,2
439,1972,100,2007,79.8,35
439,2007,79.8,2009,73.5,2
439,2009,73.5,2011,68.6,2
439,2015,71.1,2017,71.1,2
440,1966,100,2007,76.3,41
440,2007,76.3,2009,73.3,2
440,2009,73.3,2011,71.2,2
440,2013,71.7,2015,71.4,2
440,2015,71.4,2016,70.9,1
440,2016,70.9,2017,70.9,1
441,1964,100,2007,75.9,43
441,2007,75.9,2009,74.6,2
441,2009,74.6,2011,70.3,2
442,1958,100,2007,75,49
442,2007,75,2011,68.1,4
442,2011,68.1,2015,67.9,4
443,1960,100,2006,71.4,46
443,2006,71.4,2010,66.8,4
443,2010,66.8,2014,64.3,4
444,1960,100,2006,57.1,46
444,2006,57.1,2009,57.1,3
444,2009,57.1,2010,55.8,1
444,2010,55.8,2011,54.7,1
444,2013,56.9,2015,56.9,2
444,2015,56.9,2017,56.9,2
445,1980,100,2001,75,21
445,2001,75,2005,75,4
445,2005,75,2007,72.4,2
445,2007,72.4,2009,69.2,2
445,2009,69.2,2011,65.9,2
445,2013,68,2015,66.2,2
446,1972,100,2001,74.9,29
446,2001,74.9,2005,73.8,4
446,2005,73.8,2007,72.7,2
446,2009,73.6,2011,71.2,2
446,2013,72.1,2015,71.6,2
447,1971,100,2014,69.8,43
448,1971,100,2014,69.5,43
449,1964,100,2001,99.4,37
449,2001,99.4,2005,70.4,4
449,2005,70.4,2006,68.7,1
449,2008,70,2010,68.1,2
449,2010,68.1,2012,68,2
449,2012,68,2014,55.2,2
450,1975,100,2007,75.2,32
450,2007,75.2,2009,75,2
450,2009,75,2011,71.1,2
450,2013,73.2,2015,72.4,2
451,1980,100,2007,71.2,27
451,2009,73.8,2011,73.3,2
451,2011,73.3,2013,71.9,2
451,2013,71.9,2015,70.7,2
452,1979,100,2007,84.7,28
452,2007,84.7,2009,73.1,2
452,2009,73.1,2011,71.7,2
452,2013,74,2015,73.1,2
453,2007,74.2,2009,73.9,2
453,2009,73.9,2011,73.9,2
453,2013,98.3,2015,96.4,2
453,2015,96.4,2017,96,2
454,2007,73.9,2009,73.8,2
454,2009,73.8,2011,73.8,2
454,2013,97.7,2015,96.9,2
454,2015,96.9,2017,96.2,2
455,2007,82,2011,82,4
456,2007,74.1,2009,74,2
456,2009,74,2011,74,2
456,2013,98.9,2015,97.3,2
456,2015,97.3,2017,95.9,2
457,1975,100,2007,76.3,32
457,2007,76.3,2009,73.3,2
457,2009,73.3,2011,72.6,2
457,2013,73.2,2015,73.1,2
457,2015,73.1,2017,72.7,2
458,1995,100,2007,86.9,12
458,2007,86.9,2009,86.7,2
458,2009,86.7,2011,84,2
458,2013,97.8,2015,79.6,2
458,2015,79.6,2017,79.2,2
459,1995,100,2007,85.2,12
459,2007,85.2,2009,85.1,2
459,2009,85.1,2011,82.2,2
459,2013,98.8,2015,88.4,2
459,2015,88.4,2017,84.2,2
460,1973,100,2007,77.7,34
460,2007,77.7,2009,77.5,2
460,2009,77.5,2011,71.3,2
460,2013,73.2,2015,73.1,2
460,2015,73.1,2017,73,2
461,1973,100,2007,75.6,34
461,2007,75.6,2009,75.2,2
461,2009,75.2,2011,73.3,2
461,2011,73.3,2013,73,2
461,2015,74.2,2017,73.6,2
462,1973,100,2007,76.4,34
462,2007,76.4,2009,76.3,2
462,2009,76.3,2011,75.4,2
462,2011,75.4,2013,73.6,2
462,2015,73.8,2017,73.4,2
463,1975,100,2007,83,32
463,2007,83,2009,81.2,2
463,2009,81.2,2011,74.9,2
463,2015,78.9,2017,77.6,2
464,1958,100,2007,75.5,49
464,2007,75.5,2009,70.6,2
464,2009,70.6,2011,67.1,2
464,2013,69.9,2015,69.4,2
464,2015,69.4,2017,69.4,2
465,1961,100,2007,77.4,46
465,2007,77.4,2009,73.2,2
465,2009,73.2,2011,71.8,2
465,2013,73.2,2015,72.9,2
466,1958,100,2007,76.3,49
466,2007,76.3,2009,73.5,2
466,2009,73.5,2011,69.9,2
466,2013,71.5,2015,71.1,2
466,2015,71.1,2017,71.1,2
467,1975,100,2006,68.2,31
467,2010,71.8,2012,71.7,2
467,2012,71.7,2014,71,2
468,2005,100,2015,95.9,10
468,2015,95.9,2017,93.2,2
469,2005,100,2015,94.6,10
469,2015,94.6,2017,92,2
470,2005,100,2015,95.2,10
470,2015,95.2,2017,93.1,2
471,2007,92.7,2011,92.7,4
472,1995,100,2007,74.6,12
472,2007,74.6,2009,74.5,2
472,2009,74.5,2011,73.8,2
472,2013,74,2015,73.9,2
472,2015,73.9,2017,73.5,2
473,2016,100,2017,99.5,1
474,2003,61.9,2005,60.6,2
474,2007,100,2009,100,2
474,2009,100,2011,99.8,2
474,2011,99.8,2013,99.7,2
474,2013,99.7,2015,99.6,2
474,2015,99.6,2017,99.6,2
475,2003,62.5,2005,56.2,2
475,2007,100,2009,99.9,2
475,2009,99.9,2011,99.7,2
475,2011,99.7,2013,99.5,2
475,2013,99.5,2015,99.4,2
475,2015,99.4,2017,99.4,2
476,1957,100,2001,67.6,44
476,2005,75,2007,72.7,2
476,2007,72.7,2009,72.7,2
476,2009,72.7,2011,72.2,2
476,2011,72.2,2013,70.8,2
476,2013,70.8,2015,69.8,2
476,2015,69.8,2017,69.7,2
477,1983,100,2003,81.7,20
477,2003,81.7,2005,72.6,2
477,2005,72.6,2007,72,2
477,2007,72,2009,71.8,2
477,2011,73.3,2013,72.9,2
477,2013,72.9,2015,71.4,2
478,1986,100,2001,67.9,15
478,2003,73.4,2005,73,2
478,2005,73,2007,72.9,2
478,2007,72.9,2009,71.8,2
478,2011,72.5,2013,71.5,2
478,2013,71.5,2015,69.9,2
478,2015,69.9,2017,69.7,2
479,1986,100,2001,67.8,15
479,2003,75,2005,74.8,2
479,2005,74.8,2007,74.3,2
479,2007,74.3,2009,73.7,2
479,2009,73.7,2011,73.6,2
479,2011,73.6,2013,73.6,2
479,2013,73.6,2015,72.5,2
479,2015,72.5,2017,72.5,2
480,1987,100,2001,67.8,14
480,2003,75,2005,74.1,2
480,2005,74.1,2007,73.8,2
480,2007,73.8,2009,73.6,2
480,2011,74.1,2013,73.8,2
480,2013,73.8,2015,73,2
480,2015,73,2017,71.3,2
481,1987,100,2001,67.9,14
481,2003,75,2005,74.1,2
481,2005,74.1,2007,73.8,2
481,2007,73.8,2009,73.6,2
481,2011,74.1,2013,73.8,2
481,2013,73.8,2015,73.5,2
481,2015,73.5,2017,72.6,2
482,1987,100,2001,71.9,14
482,2003,75,2005,74.8,2
482,2005,74.8,2007,74.3,2
482,2007,74.3,2009,74.2,2
482,2011,74.6,2013,74.2,2
482,2013,74.2,2015,73.5,2
483,1976,100,2001,68,25
483,2003,75,2005,74.3,2
483,2005,74.3,2007,73.9,2
483,2007,73.9,2009,73.1,2
483,2009,73.1,2011,72.3,2
483,2011,72.3,2013,72.1,2
483,2013,72.1,2015,72,2
483,2015,72,2017,71.5,2
484,1976,100,2001,54.2,25
484,2009,78.4,2011,76.9,2
484,2011,76.9,2013,75.3,2
484,2013,75.3,2015,73.3,2
484,2015,73.3,2017,72.9,2
485,1976,100,2001,68,25
485,2003,75,2005,74.6,2
485,2005,74.6,2007,73.8,2
485,2007,73.8,2009,72.8,2
485,2009,72.8,2011,72.2,2
485,2011,72.2,2013,71.6,2
485,2013,71.6,2015,70.9,2
485,2015,70.9,2017,70.8,2
486,1954,100,2001,68,47
486,2003,72.8,2005,68,2
486,2005,68,2007,67.2,2
486,2011,70.7,2013,70.1,2
486,2013,70.1,2015,69.6,2
487,1976,100,2001,68,25
487,2003,75,2005,74.9,2
487,2005,74.9,2007,74.9,2
487,2007,74.9,2011,68.8,4
487,2011,68.8,2013,68.4,2
487,2013,68.4,2015,67.5,2
487,2015,67.5,2017,67.2,2
488,1959,100,2001,68,42
488,2003,75,2005,75,2
488,2005,75,2007,75,2
488,2007,75,2009,71.1,2
488,2011,71.5,2013,71.5,2
488,2013,71.5,2015,71.1,2
488,2015,71.1,2017,70.8,2
489,1993,100,2005,86.9,12
489,2005,86.9,2007,86,2
489,2011,87.9,2013,84.3,2
489,2013,84.3,2015,84.1,2
489,2015,84.1,2017,83.9,2
490,1993,100,2003,75,10
490,2005,85.6,2007,84.8,2
490,2011,87.9,2013,84,2
490,2013,84,2015,83.9,2
490,2015,83.9,2017,83.8,2
491,2009,100,2010,99.9,1
491,2010,99.9,2012,99.6,2
491,2012,99.6,2014,99.3,2
491,2014,99.3,2016,97.5,2
492,1964,100,2000,75,36
492,2000,75,2003,72.1,3
492,2003,72.1,2006,72.1,3
492,2010,73.7,2012,73.7,2
492,2012,73.7,2014,73.6,2
492,2014,73.6,2016,73.3,2
493,1958,100,2000,67.9,42
493,2003,71.9,2006,71.8,3
493,2008,73.1,2010,73.1,2
493,2010,73.1,2012,72.7,2
493,2012,72.7,2014,72.6,2
493,2014,72.6,2016,72.4,2
494,1961,100,2003,74.8,42
494,2003,74.8,2004,74.7,1
494,2004,74.7,2006,74.7,2
494,2006,74.7,2008,74.4,2
494,2012,78.5,2014,78.4,2
494,2014,78.4,2016,78.3,2
495,1958,100,2002,75,44
495,2002,75,2003,72,1
495,2003,72,2006,72,3
495,2008,73.7,2010,73.6,2
495,2010,73.6,2012,73.4,2
495,2012,73.4,2014,73.3,2
495,2014,73.3,2016,73,2
496,1957,100,2006,74.9,49
496,2006,74.9,2008,74.6,2
496,2008,74.6,2010,74.4,2
496,2010,74.4,2012,74.3,2
496,2012,74.3,2014,74,2
496,2014,74,2016,73.9,2
497,2001,100,2009,75,8
497,2009,75,2011,74.9,2
497,2011,74.9,2013,74.9,2
497,2013,74.9,2015,74.7,2
497,2015,74.7,2017,74.7,2
498,1979,100,2002,76.6,23
498,2002,76.6,2003,73.5,1
498,2003,73.5,2006,73.5,3
498,2008,74.2,2010,74,2
498,2010,74,2012,73.9,2
498,2012,73.9,2014,73.9,2
498,2014,73.9,2016,73.3,2
499,1993,100,2005,75.3,12
499,2005,75.3,2006,75,1
499,2008,96.7,2010,75,2
499,2010,75,2012,74.7,2
499,2014,75.2,2016,74.8,2
500,1993,100,2006,75,13
500,2008,97,2010,74.7,2
500,2010,74.7,2012,74.6,2
500,2014,75.2,2016,74.8,2
501,1976,100,2006,74.4,30
501,2006,74.4,2008,73.8,2
501,2008,73.8,2010,73.6,2
501,2010,73.6,2012,72.8,2
501,2012,72.8,2014,71.9,2
501,2014,71.9,2016,70.7,2
502,1976,100,2006,74.4,30
502,2006,74.4,2008,74.1,2
502,2008,74.1,2010,73.3,2
502,2010,73.3,2012,72.4,2
502,2012,72.4,2014,70.3,2
502,2014,70.3,2016,69.8,2
503,1987,100,2007,93,20
503,2007,93,2011,92.2,4
503,2011,92.2,2014,91.9,3
504,1987,100,2006,74.8,19
504,2006,74.8,2008,74.3,2
504,2008,74.3,2010,73.7,2
504,2010,73.7,2012,73.6,2
504,2012,73.6,2014,73.5,2
504,2014,73.5,2016,73.4,2
505,1976,100,2007,76.8,31
505,2007,76.8,2009,74.6,2
505,2009,74.6,2011,74.5,2
505,2011,74.5,2013,74.4,2
505,2013,74.4,2015,73.6,2
506,1976,100,2007,95.3,31
506,2007,95.3,2011,95,4
506,2011,95,2014,94.6,3
507,2000,100,2011,98.7,11
507,2011,98.7,2013,95.7,2
507,2013,95.7,2015,92.8,2
507,2015,92.8,2017,87.6,2
508,2007,100,2015,94.6,8
508,2015,94.6,2017,91.6,2
509,2007,100,2015,94.8,8
509,2015,94.8,2017,93.7,2
510,2008,100,2015,96.2,7
510,2015,96.2,2017,87.5,2
511,2008,100,2015,96.2,7
511,2015,96.2,2017,91.6,2
512,2008,100,2015,97.8,7
512,2015,97.8,2017,90.6,2
513,2008,100,2015,94.5,7
513,2015,94.5,2017,88.5,2
514,2003,100,2007,99.5,4
514,2007,99.5,2011,99.4,4
514,2011,99.4,2014,97.9,3
515,2003,100,2007,99.4,4
515,2007,99.4,2011,97.5,4
515,2011,97.5,2014,94.6,3
515,2014,94.6,2016,92,2
516,2003,100,2007,97.8,4
516,2007,97.8,2011,97.7,4
516,2011,97.7,2014,95.1,3
517,2006,100,2007,99.6,1
517,2007,99.6,2011,99.5,4
517,2011,99.5,2014,99.2,3
518,2006,100,2007,99.4,1
518,2007,99.4,2011,99.3,4
518,2011,99.3,2014,98.5,3
519,2006,100,2007,99.7,1
519,2007,99.7,2011,99.7,4
519,2011,99.7,2014,99.4,3
520,2010,100,2015,99.2,5
520,2015,99.2,2017,96.1,2
521,2010,100,2015,99.1,5
521,2015,99.1,2017,96.4,2
522,2010,100,2015,99.5,5
522,2015,99.5,2017,95.8,2
523,2009,100,2017,87.5,8
524,2007,100,2009,99.8,2
524,2009,99.8,2011,99.6,2
524,2011,99.6,2014,99.3,3
525,2006,100,2011,75,5
525,2015,99.6,2017,88.2,2
526,2016,100,2017,96.2,1
527,2016,100,2017,97.4,1
528,2016,100,2017,96.5,1
529,2016,100,2017,99.7,1
530,1964,100,2001,70.9,37
530,2001,70.9,2002,68.1,1
530,2006,73.5,2008,72.7,2
530,2010,73.1,2012,72.5,2
530,2012,72.5,2014,69.2,2
530,2014,69.2,2016,68.1,2
531,1984,100,2001,72.8,17
531,2001,72.8,2002,72.4,1
531,2002,72.4,2004,72.2,2
531,2006,73.4,2008,72.7,2
531,2008,72.7,2010,71.9,2
531,2014,73.1,2016,72.8,2
532,1969,100,2001,61.1,32
532,2001,61.1,2002,61,1
532,2006,73.9,2008,73.8,2
532,2008,73.8,2010,72.8,2
532,2010,72.8,2012,72.6,2
532,2012,72.6,2014,72.6,2
532,2014,72.6,2016,72.6,2
533,1965,100,2001,74.2,36
533,2001,74.2,2002,74.1,1
533,2002,74.1,2004,73.9,2
533,2004,73.9,2006,73.8,2
533,2008,74,2010,72.9,2
533,2012,75,2014,72.9,2
534,1967,100,2001,68,34
534,2001,68,2002,68,1
534,2002,68,2004,68,2
534,2006,74.2,2008,73.9,2
534,2008,73.9,2010,73.4,2
534,2012,73.7,2014,73.6,2
534,2014,73.6,2016,73.5,2
535,1967,100,2001,68.1,34
535,2001,68.1,2002,68,1
535,2002,68,2004,68,2
535,2006,74.1,2008,73.7,2
535,2008,73.7,2010,71.9,2
536,1967,100,2001,68.1,34
536,2001,68.1,2002,68,1
536,2002,68,2004,68,2
536,2006,73.8,2008,73.4,2
536,2008,73.4,2010,72.6,2
536,2010,72.6,2012,72.6,2
536,2012,72.6,2014,72.5,2
537,1967,100,2001,67.4,34
537,2004,73.6,2006,72,2
537,2006,72,2008,72,2
537,2008,72,2010,68.1,2
537,2010,68.1,2012,67.8,2
537,2012,67.8,2014,67.6,2
538,1969,100,2001,74,32
538,2001,74,2002,74,1
538,2006,74.6,2008,74.6,2
538,2008,74.6,2010,70.6,2
538,2012,70.7,2014,70.7,2
538,2014,70.7,2016,70.6,2
539,1969,100,2001,67.2,32
539,2004,72.9,2006,72.6,2
539,2006,72.6,2008,72.6,2
539,2008,72.6,2010,67.7,2
539,2010,67.7,2012,67.7,2
539,2014,67.8,2016,67.8,2
540,1969,100,2001,68.2,32
540,2001,68.2,2002,68.1,1
540,2002,68.1,2004,67.1,2
540,2006,71.4,2008,71.4,2
540,2008,71.4,2010,67.8,2
540,2010,67.8,2012,67.8,2
540,2012,67.8,2014,66.9,2
541,1965,100,2001,71.3,36
541,2002,71.5,2004,70.9,2
541,2008,73.8,2010,72.2,2
541,2012,72.4,2014,71.9,2
541,2014,71.9,2016,71.8,2
542,1965,100,2001,67.6,36
542,2004,73.1,2006,73,2
542,2008,74.2,2010,73.3,2
542,2010,73.3,2012,73.3,2
542,2012,73.3,2014,72.9,2
542,2014,72.9,2016,72.5,2
543,1956,100,2001,71.3,45
543,2002,71.5,2004,65.6,2
543,2008,74.1,2010,72,2
543,2012,73.2,2014,72.5,2
543,2014,72.5,2016,71.4,2
544,1993,100,2001,70.4,8
544,2002,70.5,2004,70.4,2
544,2008,73.2,2010,69.1,2
544,2012,69.3,2014,68.9,2
544,2014,68.9,2016,68.5,2
545,1993,100,2001,63.4,8
545,2008,73.8,2010,72.6,2
545,2012,72.7,2014,72.4,2
545,2014,72.4,2016,71.9,2
546,1993,100,2001,41.5,8
546,2001,41.5,2002,39.9,1
546,2004,69.4,2006,69,2
546,2008,70.9,2010,69.5,2
546,2010,69.5,2012,69.1,2
546,2012,69.1,2014,68.6,2
546,2014,68.6,2016,67.7,2
547,1992,100,2001,75.4,9
547,2001,75.4,2002,75,1
547,2002,75,2004,74.5,2
547,2006,75,2008,75,2
547,2008,75,2010,74.9,2
547,2010,74.9,2012,74.7,2
547,2012,74.7,2014,74.7,2
547,2014,74.7,2016,74.6,2
548,1959,100,2000,65.6,41
548,2002,67.2,2004,60.5,2
548,2004,60.5,2006,57.9,2
548,2012,66.9,2014,65.1,2
548,2014,65.1,2016,63.8,2
549,1983,100,2000,72.4,17
549,2006,74.2,2008,74.2,2
549,2010,74.7,2012,74.5,2
549,2012,74.5,2014,74.3,2
549,2014,74.3,2016,74.3,2
550,1984,100,2000,74.8,16
550,2002,89.9,2004,74.9,2
550,2004,74.9,2006,74.5,2
550,2008,74.6,2010,73.5,2
550,2012,73.7,2014,73.6,2
550,2014,73.6,2016,73.5,2
551,1952,100,2000,72.4,48
551,2000,72.4,2002,72.4,2
551,2006,73.1,2008,71.6,2
551,2008,71.6,2010,70.4,2
551,2010,70.4,2012,67.1,2
551,2012,67.1,2014,64.7,2
552,1985,100,2000,74.6,15
552,2000,74.6,2002,74.5,2
552,2004,74.8,2006,74.8,2
552,2006,74.8,2008,74.8,2
552,2008,74.8,2010,74.6,2
552,2012,74.7,2014,74.5,2
552,2014,74.5,2016,74.3,2
553,1938,100,2000,67.6,62
553,2000,67.6,2002,32.1,2
553,2004,66.8,2006,66.8,2
553,2006,66.8,2008,66.8,2
553,2010,73.3,2012,72.8,2
553,2012,72.8,2014,71.4,2
554,1984,100,2000,74.6,16
554,2000,74.6,2002,74.6,2
554,2002,74.6,2004,74.3,2
554,2004,74.3,2006,74.3,2
554,2008,74.4,2010,74,2
554,2010,74,2012,72.9,2
555,1984,100,2000,75,16
555,2002,82.4,2004,75,2
555,2004,75,2006,75,2
555,2006,75,2008,74.9,2
555,2008,74.9,2010,74.9,2
555,2010,74.9,2012,74.6,2
555,2012,74.6,2014,74.5,2
555,2014,74.5,2016,74.5,2
556,1984,100,2000,75,16
556,2000,75,2002,75,2
556,2002,75,2004,75,2
556,2004,75,2006,75,2
556,2006,75,2008,75,2
556,2008,75,2010,74.8,2
556,2010,74.8,2012,74.7,2
556,2012,74.7,2014,74.5,2
556,2014,74.5,2016,74.4,2
557,1984,100,2000,75,16
557,2000,75,2002,75,2
557,2002,75,2004,75,2
557,2004,75,2006,75,2
557,2006,75,2008,75,2
557,2008,75,2010,75,2
557,2010,75,2012,74.4,2
557,2012,74.4,2014,74.1,2
558,1984,100,2000,75,16
558,2004,84.1,2006,74.8,2
558,2006,74.8,2008,74.6,2
558,2008,74.6,2010,74.6,2
558,2010,74.6,2012,74.4,2
558,2012,74.4,2014,74.3,2
559,1984,100,2000,75,16
559,2002,84.4,2004,75,2
559,2004,75,2006,74.8,2
559,2006,74.8,2008,74.8,2
559,2008,74.8,2010,74.7,2
559,2010,74.7,2012,74.5,2
559,2012,74.5,2014,74.1,2
559,2014,74.1,2016,74.1,2
560,1984,100,2000,74.6,16
560,2004,75,2006,75,2
560,2010,75.5,2012,75.5,2
560,2012,75.5,2014,74.9,2
560,2014,74.9,2016,74.8,2
561,1984,100,2004,75,20
561,2004,75,2006,75,2
561,2006,75,2008,74.7,2
561,2008,74.7,2010,74.6,2
561,2010,74.6,2012,74.6,2
561,2012,74.6,2014,74.6,2
561,2014,74.6,2016,74.6,2
562,1985,100,2000,74.4,15
562,2000,74.4,2002,74,2
562,2002,74,2004,73.9,2
562,2008,75.3,2010,74.5,2
562,2010,74.5,2012,74.1,2
562,2012,74.1,2014,74.1,2
562,2014,74.1,2016,73.9,2
563,1972,100,2000,73.4,28
563,2002,77.7,2004,74.7,2
563,2004,74.7,2006,74.4,2
563,2008,74.9,2010,74.2,2
563,2010,74.2,2012,73.2,2
563,2012,73.2,2014,72.1,2
564,1967,100,2000,75,33
564,2002,100,2004,75,2
564,2004,75,2006,75,2
564,2006,75,2008,75,2
564,2008,75,2010,74.9,2
564,2010,74.9,2012,74.8,2
564,2012,74.8,2014,74.5,2
564,2014,74.5,2016,74.4,2
565,1974,100,2009,75,35
565,2009,75,2013,74.9,4
565,2013,74.9,2017,74.8,4
566,1974,100,2007,70.1,33
566,2007,70.1,2011,69.8,4
566,2011,69.8,2015,68.3,4
567,1977,100,2009,74.1,32
567,2009,74.1,2013,73.9,4
567,2013,73.9,2017,73.9,4
568,1977,100,2009,75,32
568,2009,75,2013,75,4
568,2013,75,2017,75,4
569,1977,100,2007,75,30
569,2007,75,2011,71.1,4
569,2011,71.1,2015,71,4
570,1983,100,2007,75,24
570,2007,75,2011,74,4
570,2011,74,2015,74,4
571,1985,100,2009,74.8,24
571,2009,74.8,2013,73.3,4
572,1967,100,2006,71.4,39
572,2006,71.4,2009,71.4,3
572,2009,71.4,2013,70.9,4
572,2013,70.9,2017,70.9,4
573,1967,100,2006,73.5,39
573,2006,73.5,2010,71.9,4
573,2010,71.9,2014,71.5,4
574,1972,100,2006,73.2,34
574,2006,73.2,2010,72.4,4
574,2010,72.4,2014,71.9,4
575,1954,100,2000,72.9,46
575,2002,74.9,2004,66.9,2
575,2004,66.9,2006,66.9,2
575,2006,66.9,2008,66,2
575,2008,66,2010,65.9,2
575,2010,65.9,2012,65.5,2
575,2014,65.9,2016,65.3,2
576,1971,100,2000,75,29
576,2000,75,2003,75,3
576,2003,75,2006,75,3
576,2006,75,2008,72.5,2
576,2008,72.5,2010,72.4,2
576,2010,72.4,2012,72.2,2
576,2012,72.2,2014,71.7,2
577,1971,100,2000,75,29
577,2000,75,2003,75,3
577,2003,75,2006,75,3
577,2006,75,2008,72.7,2
577,2008,72.7,2010,72.6,2
577,2010,72.6,2012,72.3,2
577,2012,72.3,2014,72.3,2
578,1972,100,2000,74.1,28
578,2000,74.1,2002,73.9,2
578,2002,73.9,2004,69,2
578,2004,69,2006,69,2
578,2006,69,2008,68.9,2
578,2008,68.9,2010,68.8,2
578,2012,69.8,2014,69.3,2
578,2014,69.3,2016,67.5,2
579,2007,100,2008,75,1
579,2010,75.1,2012,74.9,2
579,2012,74.9,2014,74.8,2
579,2014,74.8,2016,74.8,2
580,2006,100,2007,99.4,1
580,2007,99.4,2011,92.1,4
580,2011,92.1,2015,90.7,4
581,2006,100,2007,99.4,1
581,2007,99.4,2011,92.6,4
581,2011,92.6,2015,90.7,4
582,2006,100,2009,98.9,3
582,2009,98.9,2013,86.8,4
582,2013,86.8,2015,82.7,2
583,2006,100,2009,99.5,3
583,2009,99.5,2013,87.3,4
583,2013,87.3,2015,83.3,2
584,2001,100,2009,93,8
584,2009,93,2013,86.9,4
584,2013,86.9,2017,83.2,4
585,2001,100,2009,90.2,8
585,2009,90.2,2013,88.2,4
585,2013,88.2,2017,82.2,4
586,1999,100,2007,89.3,8
586,2007,89.3,2009,87.4,2
586,2009,87.4,2011,87.4,2
586,2011,87.4,2013,87.4,2
586,2013,87.4,2017,79.2,4
587,1999,100,2006,85.7,7
587,2008,94.8,2010,92.7,2
587,2010,92.7,2012,88.4,2
587,2012,88.4,2014,80.5,2
587,2014,80.5,2016,79.3,2
588,2004,100,2009,90.6,5
588,2009,90.6,2013,89.8,4
588,2013,89.8,2017,85.8,4
589,2004,100,2009,88.3,5
589,2009,88.3,2013,88.3,4
589,2013,88.3,2017,85.2,4
590,2007,100,2008,99.5,1
590,2008,99.5,2012,86.6,4
590,2012,86.6,2016,84.5,4
591,2007,100,2008,99,1
591,2008,99,2012,87.1,4
591,2012,87.1,2016,85.2,4
592,2007,100,2008,99.2,1
592,2008,99.2,2012,89.4,4
592,2012,89.4,2016,84.9,4
593,2007,100,2008,100,1
593,2008,100,2012,90.1,4
593,2012,90.1,2016,86.3,4
594,1959,100,2003,73.9,44
594,2003,73.9,2005,72.9,2
594,2005,72.9,2007,72.9,2
594,2007,72.9,2009,72.4,2
594,2009,72.4,2011,66.1,2
594,2013,66.2,2015,66,2
595,1982,100,2001,75,19
595,2001,75,2003,74.8,2
595,2005,74.9,2007,74.8,2
595,2007,74.8,2009,74.8,2
595,2011,74.9,2013,74.1,2
595,2015,74.6,2017,74.5,2
596,1983,100,2000,90.7,17
596,2000,90.7,2003,90.4,3
596,2003,90.4,2004,87,1
596,2006,87.1,2008,73.6,2
596,2012,74.8,2014,74.2,2
596,2014,74.2,2016,73.7,2
597,1968,100,2003,74.7,35
597,2003,74.7,2005,74.7,2
597,2007,75,2008,74.9,1
597,2008,74.9,2010,72.2,2
597,2010,72.2,2012,67.3,2
597,2012,67.3,2014,67.3,2
597,2014,67.3,2016,67.3,2
598,1932,100,2003,68.1,71
598,2008,73.2,2010,72.4,2
598,2010,72.4,2012,68.8,2
598,2014,74.5,2016,73.7,2
599,1961,100,2004,73.8,43
599,2004,73.8,2006,72.1,2
599,2008,74.8,2010,74.4,2
599,2010,74.4,2012,73.8,2
599,2014,74.6,2016,74.6,2
600,1965,100,2005,71.4,40
600,2005,71.4,2007,67.7,2
600,2009,71.5,2011,68.1,2
600,2011,68.1,2013,68.1,2
600,2013,68.1,2015,68.1,2
600,2015,68.1,2017,66.2,2
601,1973,100,2001,70.8,28
601,2003,74.9,2005,66,2
601,2005,66,2007,66,2
601,2009,74.4,2011,74.4,2
601,2011,74.4,2013,74.4,2
601,2013,74.4,2015,74.2,2
601,2015,74.2,2017,74.1,2
602,1976,100,2001,90.9,25
602,2001,90.9,2003,78.2,2
602,2003,78.2,2005,69.5,2
602,2005,69.5,2007,66.4,2
602,2013,80.3,2015,78.1,2
602,2015,78.1,2017,77,2
603,2010,100,2013,96,3
603,2013,96,2015,91.5,2
603,2015,91.5,2017,88.8,2
604,1969,100,2006,55.8,37
604,2006,55.8,2008,24.6,2
604,2008,24.6,2010,24.6,2
604,2011,38,2012,37.9,1
604,2012,37.9,2013,37.7,1
604,2013,37.7,2014,37.7,1
604,2015,38.6,2016,36.1,1
604,2016,36.1,2017,36.1,1
605,1963,100,2005,75,42
605,2005,75,2007,71.1,2
605,2009,72.8,2011,72.7,2
605,2011,72.7,2013,72.1,2
605,2013,72.1,2015,72.1,2
605,2015,72.1,2017,72.1,2
606,2015,100,2017,95.8,2
607,2014,100,2017,96.3,3
608,2015,100,2017,99.9,2
609,2010,100,2014,93.9,4
610,2011,100,2014,97.6,3
610,2014,97.6,2016,94.5,2
611,2011,100,2014,97.3,3
611,2014,97.3,2016,94.2,2
612,2011,100,2014,97.5,3
612,2014,97.5,2016,95.7,2
613,2011,100,2014,97.1,3
613,2014,97.1,2016,94.2,2
614,2011,100,2014,97,3
614,2014,97,2016,94.3,2
615,2013,100,2015,97.4,2
616,2013,100,2015,97.6,2
617,2013,100,2015,97.2,2
618,2013,100,2015,96.4,2
619,1954,100,2009,73.9,55
619,2009,73.9,2011,70.9,2
619,2013,72.1,2015,69.2,2
619,2015,69.2,2017,69.2,2
620,1965,100,2009,74.1,44
620,2009,74.1,2011,72.5,2
620,2011,72.5,2013,71.6,2
620,2013,71.6,2015,69.3,2
620,2015,69.3,2017,69.3,2
621,2011,100,2012,100,1
621,2012,100,2014,99,2
622,2014,99.8,2016,96.2,2
623,1950,100,2009,74,59
623,2009,74,2011,70.9,2
623,2011,70.9,2013,70.6,2
623,2013,70.6,2015,69.5,2
624,1946,100,2001,93,55
624,2001,93,2002,68.7,1
624,2002,68.7,2005,68.5,3
624,2007,70.3,2009,70,2
624,2013,95.8,2015,88.3,2
624,2015,88.3,2017,88.3,2
625,1948,100,2001,71.7,53
625,2001,71.7,2002,71.1,1
625,2002,71.1,2006,70.2,4
625,2007,73.1,2009,72.1,2
625,2009,72.1,2011,68.4,2
625,2011,68.4,2013,52.6,2
625,2015,70.1,2017,70.1,2
626,1946,100,2001,74.9,55
626,2001,74.9,2002,73.4,1
626,2002,73.4,2006,73.1,4
626,2006,73.1,2007,72.8,1
626,2007,72.8,2009,72.5,2
626,2009,72.5,2011,69.9,2
626,2011,69.9,2013,68.9,2
627,1970,100,2001,74,31
627,2006,74.5,2010,74,4
627,2010,74,2014,73.9,4
628,1990,100,2001,73.6,11
628,2007,74.6,2009,74.6,2
628,2009,74.6,2011,74.6,2
628,2015,75.1,2017,74.4,2
629,1988,100,2001,74.9,13
629,2001,74.9,2003,74.2,2
629,2003,74.2,2005,74.1,2
629,2005,74.1,2007,74,2
629,2011,74.6,2013,74.2,2
629,2013,74.2,2015,73.7,2
629,2015,73.7,2017,73.3,2
630,1990,100,2001,75,11
630,2001,75,2003,74.3,2
630,2003,74.3,2005,74.2,2
630,2005,74.2,2007,74,2
630,2009,74.2,2011,74.2,2
630,2011,74.2,2013,74.1,2
630,2013,74.1,2015,74.1,2
630,2015,74.1,2017,73.7,2
631,1950,100,2001,72.5,51
631,2001,72.5,2002,60.5,1
631,2002,60.5,2006,58.6,4
631,2010,61.4,2014,60.8,4
632,1976,100,2001,75,25
632,2001,75,2002,75,1
632,2002,75,2006,72.8,4
632,2010,74.2,2012,73.3,2
632,2012,73.3,2014,72,2
633,1993,100,2001,74.6,8
633,2001,74.6,2002,73.5,1
633,2002,73.5,2006,71,4
633,2010,71.3,2012,71.2,2
634,1993,100,2001,75,8
634,2001,75,2002,75,1
634,2002,75,2006,75,4
634,2006,75,2010,74.5,4
634,2010,74.5,2014,73.9,4
635,1993,100,2001,74.9,8
635,2001,74.9,2002,74.9,1
635,2002,74.9,2006,74.7,4
635,2006,74.7,2010,72.9,4
635,2010,72.9,2012,71.3,2
635,2012,71.3,2014,70.4,2
636,1993,100,2001,75,8
636,2001,75,2002,75,1
636,2002,75,2006,75,4
636,2006,75,2010,74.9,4
636,2012,75.3,2014,75.3,2
637,1993,100,2001,74.9,8
637,2001,74.9,2002,74.9,1
637,2002,74.9,2006,74.8,4
637,2006,74.8,2010,74.3,4
637,2010,74.3,2014,73.2,4
638,1976,100,2001,99.8,25
638,2001,99.8,2003,99.8,2
638,2003,99.8,2006,74,3
638,2006,74,2010,74,4
638,2010,74,2014,73.8,4
639,1976,100,2001,75,25
639,2001,75,2003,75,2
639,2003,75,2006,72.8,3
639,2008,72.9,2010,72.7,2
639,2010,72.7,2012,70.1,2
639,2012,70.1,2014,67.8,2
639,2014,67.8,2016,67.6,2
640,1976,100,2001,75,25
640,2001,75,2003,75,2
640,2003,75,2006,75,3
640,2006,75,2010,74.4,4
640,2010,74.4,2014,73.1,4
641,1976,100,2001,74.6,25
641,2001,74.6,2003,74.6,2
641,2003,74.6,2006,74.2,3
641,2010,78.4,2014,75.2,4
642,1976,100,2001,58.1,25
642,2001,58.1,2003,58.1,2
642,2006,65.1,2008,64.2,2
642,2008,64.2,2010,60.1,2
642,2012,60.7,2014,52.3,2
642,2016,54.4,2017,53.5,1
643,1976,100,2001,64.9,25
643,2001,64.9,2003,64.9,2
643,2008,73.1,2010,72.5,2
643,2010,72.5,2012,71.8,2
643,2014,77.5,2016,75.6,2
644,1976,100,2001,75,25
644,2001,75,2006,75,5
644,2006,75,2010,75,4
645,1976,100,2001,89.7,25
645,2001,89.7,2003,89.7,2
645,2003,89.7,2006,73.9,3
645,2006,73.9,2008,66.9,2
645,2010,68.8,2012,67.7,2
645,2014,69.5,2016,68.8,2
646,1976,100,2001,75,25
646,2001,75,2003,75,2
646,2003,75,2006,74.7,3
646,2006,74.7,2010,74.2,4
647,1976,100,2001,60.4,25
647,2001,60.4,2003,60.4,2
647,2003,60.4,2006,51.1,3
647,2008,53.6,2010,52.6,2
647,2010,52.6,2012,51,2
647,2012,51,2014,49.7,2
647,2014,49.7,2016,48.9,2
648,1976,100,2001,75,25
648,2001,75,2003,75,2
648,2003,75,2006,72.2,3
648,2006,72.2,2008,68.7,2
648,2010,74.9,2012,70.4,2
649,1976,100,2001,100,25
649,2001,100,2003,100,2
649,2003,100,2006,74.5,3
649,2010,75,2014,74.9,4
650,1980,100,2001,75,21
650,2001,75,2006,74,5
650,2008,74.6,2010,73.4,2
650,2010,73.4,2012,72.1,2
650,2014,73.2,2016,72.6,2
651,1980,100,2001,74.4,21
651,2001,74.4,2006,73.8,5
651,2006,73.8,2008,72.8,2
651,2010,73,2012,72.7,2
651,2014,74,2016,73.4,2
652,1976,100,2001,74.9,25
652,2001,74.9,2006,72.4,5
652,2007,80.6,2010,74.6,3
653,1976,100,2001,97.9,25
653,2001,97.9,2002,64.7,1
653,2002,64.7,2006,64.2,4
653,2010,67.7,2014,66.6,4
654,1953,100,2001,98.5,48
654,2001,98.5,2002,71.4,1
654,2002,71.4,2006,65.7,4
654,2006,65.7,2008,57.9,2
654,2010,62.8,2012,62.2,2
654,2012,62.2,2014,57.8,2
654,2014,57.8,2016,57.8,2
655,1976,100,2001,74.9,25
655,2001,74.9,2002,73,1
655,2002,73,2006,72.6,4
655,2006,72.6,2010,70.7,4
655,2010,70.7,2014,67.7,4
656,1980,100,2001,74.6,21
656,2001,74.6,2002,57.5,1
656,2006,74.3,2010,73.2,4
656,2010,73.2,2012,70.3,2
656,2012,70.3,2014,70,2
657,1953,100,2001,75,48
657,2001,75,2002,73,1
657,2002,73,2006,73,4
657,2006,73,2008,68.5,2
657,2008,68.5,2010,67.9,2
657,2010,67.9,2012,67.4,2
657,2012,67.4,2014,66.2,2
657,2014,66.2,2016,66.2,2
658,1960,100,2001,75,41
658,2001,75,2002,74.8,1
658,2002,74.8,2005,71.7,3
658,2007,76.1,2009,73.2,2
658,2013,95.9,2015,92.4,2
658,2015,92.4,2017,92.1,2
659,1953,100,2001,68.6,48
659,2002,70,2006,70,4
659,2006,70,2008,68.9,2
659,2010,69.7,2012,68.4,2
659,2012,68.4,2014,68.1,2
659,2014,68.1,2016,68.1,2
660,1976,100,2001,74.4,25
660,2001,74.4,2006,73.6,5
660,2008,74.3,2010,73.3,2
660,2010,73.3,2012,70.8,2
660,2012,70.8,2014,70.8,2
661,1976,100,2001,75,25
661,2001,75,2006,74.2,5
661,2008,74.5,2010,74,2
661,2010,74,2012,74,2
661,2014,75.7,2016,74.5,2
662,1976,100,2001,75,25
662,2001,75,2006,73.1,5
662,2006,73.1,2008,66.4,2
662,2008,66.4,2010,65.8,2
662,2010,65.8,2012,60.4,2
662,2014,61.1,2016,60.4,2
663,1976,100,2001,75,25
663,2001,75,2006,75,5
663,2006,75,2010,74.9,4
663,2010,74.9,2012,74.2,2
663,2012,74.2,2014,73.1,2
663,2014,73.1,2016,72.6,2
664,1993,100,2001,75,8
664,2001,75,2006,75,5
664,2010,77,2014,75.3,4
665,1960,100,2001,69.3,41
665,2006,73.9,2010,73.2,4
665,2014,74.3,2016,73.6,2
666,1953,100,2001,74.6,48
666,2001,74.6,2006,62.2,5
666,2006,62.2,2008,46.8,2
666,2010,49.2,2012,46.9,2
666,2012,46.9,2014,42.1,2
666,2014,42.1,2016,40.7,2
666,2016,40.7,2017,36.7,1
667,2008,100,2015,98.8,7
667,2015,98.8,2017,98.6,2
668,2010,100,2015,99.7,5
668,2015,99.7,2017,98.5,2
669,2010,100,2011,100,1
669,2011,100,2013,100,2
669,2013,100,2015,99.4,2
669,2015,99.4,2017,90.5,2
670,2011,100,2015,96.8,4
670,2015,96.8,2017,93.9,2
671,2011,100,2015,98.4,4
671,2015,98.4,2017,98,2
672,1962,100,2000,92,38
672,2000,92,2002,69.7,2
672,2004,69.8,2006,69.8,2
672,2006,69.8,2008,68.8,2
672,2008,68.8,2010,68.7,2
672,2010,68.7,2012,68.5,2
672,2014,69.2,2016,68.8,2
673,1963,100,2009,73.3,46
673,2009,73.3,2013,68.5,4
673,2013,68.5,2015,66.3,2
674,2003,100,2009,81.8,6
674,2013,85.9,2017,74.2,4
675,2002,100,2009,89.5,7
675,2009,89.5,2013,88.5,4
675,2013,88.5,2017,84.4,4
676,2002,100,2009,91.6,7
676,2009,91.6,2013,88.4,4
676,2013,88.4,2017,83.5,4
677,2001,100,2009,85.9,8
677,2009,85.9,2013,83.9,4
677,2013,83.9,2017,74.2,4
678,1965,100,2009,86,44
678,2009,86,2013,79.4,4
678,2013,79.4,2017,73.8,4
679,2004,100,2009,93.8,5
679,2009,93.8,2013,89.8,4
679,2013,89.8,2017,76.7,4
680,2004,100,2009,86.4,5
680,2013,86.9,2017,76.4,4
681,2004,100,2009,93.8,5
681,2009,93.8,2013,89.5,4
681,2013,89.5,2017,86.4,4
682,2004,100,2009,90.4,5
682,2009,90.4,2013,88.2,4
682,2013,88.2,2017,74.3,4
683,2004,100,2009,88.4,5
683,2009,88.4,2013,88.3,4
683,2013,88.3,2017,73.8,4
684,2004,100,2009,90.2,5
684,2009,90.2,2013,88.5,4
684,2013,88.5,2017,75.5,4
685,2005,100,2006,75,1
685,2009,88.7,2013,88.5,4
685,2013,88.5,2017,78.1,4
686,1955,100,2006,68.4,51
686,2006,68.4,2008,59.3,2
686,2008,59.3,2010,58.4,2
686,2010,58.4,2012,55.4,2
686,2012,55.4,2014,54.7,2
686,2014,54.7,2016,54.7,2
687,1981,100,2000,64.4,19
687,2000,64.4,2002,41.5,2
687,2004,57.5,2006,57.5,2
687,2006,57.5,2008,57.5,2
687,2010,71.7,2012,71.5,2
687,2012,71.5,2014,71.1,2
688,1902,100,2000,72.4,98
688,2000,72.4,2002,70.9,2
688,2004,72.4,2006,70.9,2
688,2006,70.9,2008,66.6,2
688,2008,66.6,2010,64.3,2
688,2010,64.3,2012,63.6,2
688,2012,63.6,2014,63.2,2
688,2014,63.2,2016,63.2,2
689,1975,100,2009,71.3,34
689,2009,71.3,2013,70.7,4
689,2013,70.7,2017,70.4,4
690,1975,100,2009,74.5,34
690,2009,74.5,2013,74.5,4
690,2013,74.5,2017,74.5,4
691,1992,100,2001,75,9
691,2001,75,2003,75,2
691,2003,75,2005,75,2
691,2005,75,2007,71.9,2
691,2009,73.5,2011,71.8,2
691,2011,71.8,2013,71.4,2
692,1969,100,2001,71.6,32
692,2003,75,2005,75,2
692,2005,75,2007,69.2,2
692,2009,73.6,2011,69.5,2
692,2011,69.5,2013,69.5,2
692,2015,69.6,2017,69.5,2
693,1966,100,2001,75,35
693,2001,75,2005,75,4
693,2005,75,2007,74.9,2
693,2007,74.9,2009,74.6,2
693,2009,74.6,2011,73.8,2
693,2011,73.8,2013,73.5,2
693,2013,73.5,2015,73.4,2
693,2015,73.4,2017,73.2,2
694,1966,100,2005,75,39
694,2005,75,2007,74.9,2
694,2007,74.9,2009,74.8,2
694,2009,74.8,2011,74.4,2
694,2011,74.4,2013,74.2,2
694,2013,74.2,2015,73.9,2
695,1966,100,2001,75,35
695,2001,75,2005,75,4
695,2005,75,2007,74.9,2
695,2007,74.9,2009,74.6,2
695,2009,74.6,2011,71.9,2
695,2011,71.9,2013,71.8,2
695,2013,71.8,2015,71.5,2
696,1970,100,2007,75,37
696,2007,75,2009,75,2
696,2009,75,2011,74.8,2
696,2011,74.8,2013,74.8,2
696,2013,74.8,2015,74.7,2
697,1970,100,2001,75,31
697,2001,75,2005,75,4
697,2005,75,2007,69.6,2
697,2007,69.6,2009,69.4,2
697,2009,69.4,2011,61.5,2
697,2013,66.6,2015,66.4,2
698,1970,100,2001,75,31
698,2001,75,2003,75,2
698,2003,75,2005,75,2
698,2005,75,2007,73.8,2
698,2007,73.8,2009,73.6,2
698,2009,73.6,2011,71.1,2
698,2011,71.1,2013,70.9,2
698,2013,70.9,2015,70.8,2
699,1970,100,2001,71.5,31
699,2003,75,2005,75,2
699,2005,75,2007,75,2
699,2007,75,2009,75,2
699,2009,75,2011,74.4,2
699,2015,74.7,2017,74.7,2
700,1994,100,2001,75,7
700,2001,75,2003,75,2
700,2003,75,2005,75,2
700,2005,75,2007,73.8,2
700,2007,73.8,2009,73.8,2
700,2009,73.8,2011,73.6,2
700,2011,73.6,2013,73.3,2
700,2013,73.3,2015,73.1,2
700,2015,73.1,2017,72.9,2
701,1994,100,2001,75,7
701,2001,75,2003,75,2
701,2003,75,2005,75,2
701,2005,75,2007,74.8,2
701,2007,74.8,2009,74.7,2
701,2009,74.7,2011,72.4,2
701,2011,72.4,2013,72.2,2
701,2013,72.2,2015,71.9,2
702,1959,100,2001,75,42
702,2001,75,2002,75,1
702,2002,75,2004,68.7,2
702,2006,71.9,2008,71.1,2
702,2010,73,2012,72.7,2
702,2012,72.7,2014,72.4,2
702,2014,72.4,2016,72.2,2
703,1959,100,2001,75,42
703,2001,75,2002,75,1
703,2002,75,2004,75,2
703,2004,75,2006,75,2
703,2006,75,2008,74.6,2
703,2008,74.6,2010,74.5,2
703,2010,74.5,2012,74.1,2
703,2012,74.1,2014,74,2
703,2014,74,2016,73.7,2
704,1994,100,2001,75,7
704,2001,75,2003,75,2
704,2003,75,2005,75,2
704,2005,75,2007,75,2
704,2007,75,2009,74.7,2
704,2009,74.7,2011,74,2
704,2011,74,2013,73.1,2
704,2013,73.1,2015,72.4,2
704,2015,72.4,2017,72.4,2
705,1994,100,2001,75,7
705,2001,75,2003,75,2
705,2003,75,2005,75,2
705,2005,75,2007,74.4,2
705,2007,74.4,2009,74.3,2
705,2009,74.3,2011,72.2,2
705,2011,72.2,2013,71.7,2
705,2013,71.7,2015,71.5,2
706,2003,100,2004,100,1
706,2004,100,2006,100,2
706,2006,100,2008,72.8,2
706,2010,84.8,2012,81.8,2
706,2012,81.8,2014,80.7,2
706,2014,80.7,2016,78.2,2
707,1959,100,2004,75,45
707,2004,75,2006,75,2
707,2006,75,2008,74.8,2
707,2008,74.8,2010,74.3,2
707,2010,74.3,2012,73,2
707,2012,73,2014,72.5,2
707,2014,72.5,2016,72.3,2
708,1989,100,2005,75,16
708,2005,75,2007,75,2
708,2007,75,2009,74.5,2
708,2009,74.5,2011,73.6,2
708,2011,73.6,2013,73.4,2
708,2013,73.4,2015,73.4,2
708,2015,73.4,2017,73.4,2
709,1989,100,2005,75,16
709,2005,75,2007,75,2
709,2007,75,2009,73.7,2
709,2009,73.7,2011,73.6,2
709,2011,73.6,2013,73.6,2
709,2015,74,2017,73.9,2
710,1989,100,2005,75,16
710,2005,75,2007,75,2
710,2007,75,2009,75,2
710,2009,75,2011,75,2
710,2011,75,2013,74.8,2
710,2013,74.8,2015,74.8,2
711,1967,100,2010,73.5,43
711,2010,73.5,2012,73.4,2
711,2012,73.4,2014,73.3,2
711,2014,73.3,2016,73.3,2
712,1962,100,2000,89.3,38
712,2000,89.3,2005,55.4,5
712,2005,55.4,2007,55.4,2
712,2013,76.4,2015,73.4,2
712,2015,73.4,2017,72.8,2
713,1971,100,2000,96.3,29
713,2000,96.3,2003,76,3
713,2003,76,2005,64.1,2
713,2005,64.1,2006,56.4,1
713,2006,56.4,2007,56,1
713,2007,56,2009,56,2
713,2010,74.1,2012,73.8,2
713,2012,73.8,2014,73.8,2
713,2014,73.8,2016,73.8,2
714,2013,100,2015,96.7,2
714,2015,96.7,2017,96.6,2
715,1993,100,2000,99,7
715,2000,99,2005,74.7,5
715,2007,81.4,2009,81.4,2
715,2009,81.4,2011,81.1,2
715,2011,81.1,2013,80.7,2
715,2013,80.7,2015,80.7,2
716,1965,100,2007,73.6,42
716,2009,77.7,2011,74.5,2
716,2011,74.5,2013,74.3,2
716,2013,74.3,2015,73.9,2
716,2015,73.9,2017,73.8,2
717,1967,100,2007,73.6,40
717,2009,77,2011,72.5,2
717,2011,72.5,2013,72.3,2
717,2015,72.9,2017,72.4,2
718,1970,100,2007,75,37
718,2011,75.2,2013,75,2
718,2013,75,2015,71.9,2
719,1970,100,2007,73.5,37
719,2007,73.5,2009,72.3,2
719,2011,73.8,2013,73.6,2
719,2013,73.6,2015,72.1,2
720,1970,100,2007,75,37
720,2007,75,2009,70.8,2
720,2011,74.3,2013,74,2
720,2013,74,2015,70.8,2
720,2015,70.8,2017,70.3,2
721,1970,100,2007,74,37
721,2007,74,2009,72.2,2
721,2011,73.7,2013,72.6,2
721,2013,72.6,2015,71.7,2
721,2015,71.7,2017,70.8,2
722,1970,100,2007,74.2,37
722,2007,74.2,2009,73,2
722,2011,73.3,2013,73.1,2
722,2015,73.7,2017,73.7,2
723,1978,100,2007,72.3,29
723,2007,72.3,2009,71.3,2
723,2009,71.3,2011,68.4,2
723,2011,68.4,2013,68,2
723,2015,71.4,2017,70.1,2
724,1978,100,2007,83.2,29
724,2007,83.2,2009,74.3,2
724,2009,74.3,2013,74.2,4
725,1978,100,2007,70.8,29
725,2007,70.8,2009,65.8,2
725,2011,68.3,2013,68.3,2
725,2015,69.8,2017,69,2
726,1976,100,2007,83.6,31
726,2007,83.6,2011,78.7,4
726,2011,78.7,2013,74.5,2
726,2013,74.5,2015,74.4,2
726,2015,74.4,2017,74,2
727,1976,100,2007,65.6,31
727,2007,65.6,2009,61.5,2
727,2009,61.5,2011,57.6,2
727,2011,57.6,2013,56,2
727,2013,56,2015,55.3,2
728,1968,100,2007,76.1,39
728,2007,76.1,2009,70.3,2
728,2011,72.2,2013,71.8,2
728,2013,71.8,2015,71.1,2
729,1968,100,2007,74,39
729,2007,74,2009,72.3,2
729,2009,72.3,2011,70.3,2
729,2011,70.3,2013,70,2
729,2013,70,2015,65.9,2
730,2006,100,2009,100,3
730,2009,100,2011,99.6,2
730,2011,99.6,2013,99.4,2
730,2013,99.4,2015,96.6,2
730,2015,96.6,2017,96.2,2
731,2015,98.9,2017,98.9,2
732,2014,100,2015,89.8,1
732,2015,89.8,2017,87.8,2
733,2014,100,2015,89.3,1
733,2015,89.3,2017,87.9,2
734,2013,100,2015,87.9,2
734,2015,87.9,2017,86.8,2
735,2014,100,2015,95.3,1
735,2015,95.3,2017,94.3,2
736,2003,59.1,2005,59.1,2
736,2007,100,2009,99.7,2
736,2009,99.7,2011,98,2
736,2011,98,2013,97,2
736,2013,97,2015,95.2,2
736,2015,95.2,2017,87.7,2
737,1963,100,2001,63.8,38
737,2005,72.2,2006,71.7,1
737,2007,75,2009,74.3,2
737,2009,74.3,2011,70.7,2
737,2011,70.7,2013,70.6,2
737,2013,70.6,2015,70.3,2
737,2015,70.3,2017,70.3,2
738,1958,100,2001,71.5,43
738,2001,71.5,2003,71.5,2
738,2005,71.6,2007,71.2,2
738,2009,72.5,2011,72.4,2
738,2011,72.4,2013,70.6,2
738,2013,70.6,2015,69.9,2
739,1959,100,2001,73.2,42
739,2003,73.4,2005,72.8,2
739,2005,72.8,2007,72.8,2
739,2007,72.8,2009,71.1,2
739,2009,71.1,2011,69.8,2
739,2011,69.8,2013,68.7,2
739,2013,68.7,2015,67,2
739,2015,67,2017,67,2
740,1959,100,2001,64.2,42
740,2001,64.2,2003,64.1,2
740,2005,72.9,2007,72.9,2
740,2009,73,2011,72,2
740,2011,72,2013,71.2,2
740,2013,71.2,2015,70.7,2
741,1972,100,2001,80.8,29
741,2001,80.8,2003,80,2
741,2003,80,2005,74.2,2
741,2005,74.2,2007,74,2
741,2007,74,2009,73.9,2
741,2009,73.9,2011,72.7,2
741,2011,72.7,2013,72.6,2
741,2013,72.6,2015,72.3,2
741,2015,72.3,2017,72.3,2
742,1974,100,2005,74.4,31
742,2005,74.4,2007,70.7,2
742,2007,70.7,2009,70.1,2
742,2009,70.1,2011,69.8,2
742,2011,69.8,2013,69.7,2
742,2013,69.7,2015,65.7,2
742,2015,65.7,2017,63.4,2
743,1974,100,2005,72.7,31
743,2005,72.7,2007,72.5,2
743,2007,72.5,2009,72.5,2
743,2009,72.5,2011,72.1,2
743,2011,72.1,2013,72,2
744,1993,100,2001,64.9,8
744,2001,64.9,2003,64.7,2
744,2005,71.8,2007,71.8,2
744,2009,73.8,2011,70.8,2
744,2013,71,2015,70.4,2
744,2015,70.4,2017,69.9,2
745,1993,100,2001,83.9,8
745,2001,83.9,2003,73.4,2
745,2003,73.4,2005,63.6,2
745,2005,63.6,2007,57.8,2
745,2011,66.6,2013,65.2,2
745,2013,65.2,2015,63.8,2
745,2015,63.8,2017,62.9,2
746,1993,100,2001,71.5,8
746,2001,71.5,2003,71.5,2
746,2003,71.5,2005,69.9,2
746,2005,69.9,2007,65.8,2
746,2009,69.2,2011,67.9,2
746,2013,68.1,2015,67.9,2
746,2015,67.9,2017,67.9,2
747,1962,100,2001,71.5,39
747,2003,73.6,2005,70.1,2
747,2007,75.1,2009,72.9,2
747,2009,72.9,2011,70.5,2
747,2011,70.5,2013,70.4,2
747,2013,70.4,2015,69.8,2
747,2015,69.8,2017,69.5,2
748,1958,100,2001,68.1,43
748,2001,68.1,2003,68,2
748,2005,68.1,2007,67.7,2
748,2009,72.9,2011,72.9,2
748,2013,73,2015,72.2,2
748,2015,72.2,2017,72.1,2
749,1974,100,2001,64.7,27
749,2001,64.7,2003,64.6,2
749,2005,73.8,2007,73.2,2
749,2007,73.2,2009,72,2
749,2009,72,2011,71.3,2
749,2011,71.3,2013,69.4,2
749,2013,69.4,2015,68.8,2
750,1974,100,2001,68.1,27
750,2001,68.1,2003,68,2
750,2005,74.1,2007,72.6,2
750,2007,72.6,2009,72.6,2
750,2009,72.6,2011,72.6,2
750,2011,72.6,2013,72.5,2
750,2013,72.5,2015,72.3,2
750,2015,72.3,2017,72.3,2
751,1999,100,2001,71.5,2
751,2001,71.5,2003,71.5,2
751,2003,71.5,2005,71.5,2
751,2005,71.5,2007,71.5,2
751,2009,74.7,2011,74.1,2
751,2013,74.2,2015,73.5,2
752,1993,100,2001,68.6,8
752,2003,74.9,2005,71.8,2
752,2005,71.8,2007,71.6,2
752,2009,73.7,2011,72.7,2
752,2011,72.7,2013,72.3,2
752,2013,72.3,2015,71.8,2
752,2015,71.8,2017,71.7,2
753,1993,100,2001,71.5,8
753,2001,71.5,2003,71.5,2
753,2003,71.5,2005,71.2,2
753,2005,71.2,2007,71.2,2
753,2009,74,2011,73.7,2
753,2011,73.7,2013,73.7,2
753,2013,73.7,2015,73.3,2
753,2015,73.3,2017,72.8,2
754,1993,100,2001,68,8
754,2001,68,2003,68,2
754,2005,71.5,2007,71.5,2
754,2009,73.4,2011,73,2
754,2011,73,2013,72.8,2
754,2013,72.8,2015,72.2,2
754,2015,72.2,2017,71.9,2
755,1993,100,2001,67.2,8
755,2001,67.2,2003,67.2,2
755,2003,67.2,2005,66.6,2
755,2006,72.3,2007,71.9,1
755,2007,71.9,2009,71.9,2
755,2009,71.9,2011,71.3,2
755,2011,71.3,2013,70.4,2
755,2015,76.9,2017,76.5,2
756,1993,100,2001,67.8,8
756,2006,73.5,2007,73.5,1
756,2007,73.5,2009,73.4,2
756,2009,73.4,2011,69,2
756,2011,69,2013,68.9,2
756,2013,68.9,2015,67.3,2
756,2015,67.3,2017,67.2,2
757,1993,100,2001,63.7,8
757,2006,73.5,2007,72.7,1
757,2007,72.7,2009,72.7,2
757,2009,72.7,2011,69,2
757,2011,69,2013,68.1,2
757,2013,68.1,2015,67.5,2
757,2015,67.5,2017,67.1,2
758,1993,100,2001,59.9,8
758,2006,73.5,2007,73.5,1
758,2007,73.5,2009,73.1,2
758,2009,73.1,2011,69,2
758,2011,69,2013,69,2
758,2013,69,2015,68.7,2
758,2015,68.7,2017,68.2,2
759,1993,100,2001,64.4,8
759,2001,64.4,2003,64.2,2
759,2005,74.6,2006,73.9,1
759,2007,74.3,2009,74.1,2
759,2009,74.1,2011,72.7,2
759,2011,72.7,2013,72.6,2
759,2015,76.5,2017,75.4,2
760,1993,100,2001,70.4,8
760,2005,72.5,2006,71.7,1
760,2006,71.7,2007,71.7,1
760,2009,73.5,2011,72.6,2
760,2011,72.6,2013,72.4,2
760,2015,76.5,2017,75.2,2
761,1958,100,2003,74.8,45
761,2003,74.8,2005,74,2
761,2005,74,2007,74,2
761,2007,74,2009,73.7,2
761,2009,73.7,2011,71.1,2
761,2011,71.1,2013,70.7,2
761,2013,70.7,2015,70.1,2
761,2015,70.1,2017,70.1,2
762,1957,100,2005,74.6,48
762,2005,74.6,2007,74.6,2
762,2007,74.6,2008,74.5,1
762,2010,74.7,2012,74.4,2
762,2012,74.4,2014,74.4,2
763,1963,100,2003,74.9,40
763,2003,74.9,2006,74.9,3
763,2006,74.9,2008,74.5,2
763,2008,74.5,2010,73.6,2
763,2010,73.6,2012,73.6,2
763,2012,73.6,2014,73.6,2
763,2014,73.6,2016,73.6,2
764,1980,100,2000,97.6,20
764,2000,97.6,2003,75,3
764,2003,75,2004,75,1
764,2004,75,2006,75,2
764,2006,75,2008,73.6,2
764,2008,73.6,2010,71.8,2
764,2010,71.8,2012,71.6,2
764,2012,71.6,2014,71.4,2
764,2014,71.4,2016,71.4,2
765,1992,100,2002,100,10
765,2002,100,2003,70,1
765,2006,74.6,2008,73,2
765,2012,74.9,2014,74.8,2
765,2014,74.8,2016,74.4,2
766,2007,64.2,2009,60.3,2
766,2011,100,2013,99.4,2
766,2013,99.4,2017,96.3,4
767,1992,100,2007,79.4,15
767,2007,79.4,2009,72.3,2
767,2011,72.8,2013,72.8,2
767,2013,72.8,2015,70.3,2
768,1994,100,2007,78.1,13
768,2007,78.1,2009,67.6,2
768,2013,72.4,2015,72.2,2
769,1994,100,2007,74.1,13
769,2007,74.1,2009,71.3,2
769,2009,71.3,2011,70.2,2
769,2013,70.8,2015,67.1,2
770,1994,100,2007,88.6,13
770,2007,88.6,2011,83.7,4
770,2011,83.7,2013,77.2,2
770,2013,77.2,2015,68.9,2
771,1994,100,2007,73.9,13
771,2007,73.9,2009,72.8,2
771,2009,72.8,2011,71.1,2
771,2011,71.1,2013,70.9,2
771,2013,70.9,2015,70.7,2
772,1994,100,2007,74.7,13
772,2007,74.7,2009,73.6,2
772,2009,73.6,2011,72.9,2
772,2011,72.9,2013,72.9,2
772,2013,72.9,2015,70.5,2
773,1995,100,2007,92.6,12
773,2007,92.6,2011,90,4
773,2011,90,2013,89.3,2
773,2013,89.3,2015,81.9,2
773,2015,81.9,2017,80,2
774,1996,100,2007,94.8,11
774,2007,94.8,2011,90.6,4
774,2011,90.6,2013,90.6,2
774,2013,90.6,2015,89.5,2
774,2015,89.5,2017,87.7,2
775,1992,100,2007,76.3,15
775,2007,76.3,2009,74.1,2
775,2009,74.1,2011,73.8,2
775,2011,73.8,2013,73.5,2
775,2015,74.2,2017,74.1,2
776,1993,100,2002,100,9
776,2002,100,2003,70.2,1
776,2003,70.2,2006,69.9,3
776,2010,74.5,2012,73.6,2
776,2012,73.6,2014,73.6,2
776,2014,73.6,2016,73.3,2
777,2006,100,2008,99.7,2
777,2008,99.7,2010,98.4,2
777,2010,98.4,2012,98.2,2
777,2012,98.2,2014,97.9,2
777,2014,97.9,2016,95.8,2
778,2006,100,2010,100,4
778,2010,100,2012,99.2,2
778,2012,99.2,2014,86.9,2
778,2014,86.9,2016,83.9,2
779,2006,100,2010,100,4
779,2010,100,2012,99.4,2
779,2012,99.4,2014,90.7,2
779,2014,90.7,2016,88.6,2
780,2006,100,2010,100,4
780,2010,100,2012,99.9,2
780,2012,99.9,2014,87.6,2
780,2014,87.6,2016,85.7,2
781,2003,100,2007,98.9,4
781,2007,98.9,2009,77.9,2
781,2009,77.9,2013,74.9,4
781,2013,74.9,2017,74.8,4
782,2003,100,2007,98.9,4
782,2007,98.9,2009,75,2
782,2009,75,2013,75,4
782,2013,75,2017,75,4
783,2003,100,2007,98.5,4
783,2007,98.5,2009,74.2,2
783,2009,74.2,2013,74.2,4
783,2013,74.2,2017,73.8,4
784,2003,100,2007,99.6,4
784,2007,99.6,2009,75,2
784,2009,75,2013,75,4
784,2013,75,2017,74.9,4
785,2003,100,2007,99.5,4
785,2007,99.5,2009,75,2
785,2009,75,2013,75,4
785,2013,75,2017,75,4
786,1996,100,2007,98.2,11
786,2007,98.2,2009,85.9,2
786,2009,85.9,2011,83.2,2
786,2011,83.2,2013,83.2,2
786,2013,83.2,2015,81.7,2
786,2015,81.7,2017,80.1,2
787,2003,100,2007,99.3,4
787,2007,99.3,2011,94.2,4
787,2011,94.2,2013,93.8,2
787,2013,93.8,2015,92,2
787,2015,92,2017,90.1,2
788,1999,100,2007,98.9,8
788,2007,98.9,2011,97.4,4
788,2011,97.4,2014,94.9,3
789,1994,100,2003,89.8,9
789,2003,89.8,2004,74.8,1
789,2004,74.8,2006,74.8,2
789,2009,86.2,2011,85.1,2
789,2013,85.4,2015,83.3,2
789,2015,83.3,2017,83.3,2
790,1994,100,2004,74.9,10
790,2004,74.9,2006,74.8,2
790,2007,74.9,2009,74.8,2
790,2009,74.8,2011,74.7,2
790,2013,85.8,2015,82.9,2
790,2015,82.9,2017,82.8,2
791,1950,100,2006,59.3,56
791,2008,74.3,2010,72.7,2
791,2012,74,2014,73.9,2
791,2014,73.9,2016,72.9,2
792,1963,100,2000,80.2,37
792,2000,80.2,2004,62.8,4
792,2008,73.5,2010,72.7,2
792,2010,72.7,2012,72.3,2
792,2012,72.3,2014,70.9,2
792,2014,70.9,2016,70.6,2
793,1990,100,2000,98.7,10
793,2000,98.7,2005,74.8,5
793,2005,74.8,2007,74.8,2
793,2007,74.8,2009,74.7,2
793,2009,74.7,2011,74.7,2
793,2011,74.7,2013,74.7,2
793,2013,74.7,2015,74.6,2
794,1990,100,2000,98.9,10
794,2000,98.9,2005,74.6,5
794,2005,74.6,2007,74.6,2
794,2007,74.6,2009,74.5,2
794,2009,74.5,2011,74.4,2
794,2013,74.5,2015,74.4,2
795,1976,100,2001,74.8,25
795,2001,74.8,2004,74.8,3
795,2004,74.8,2006,74.8,2
795,2006,74.8,2007,74.8,1
795,2007,74.8,2009,74.6,2
795,2009,74.6,2011,74.6,2
795,2011,74.6,2013,74,2
795,2013,74,2015,73.8,2
795,2015,73.8,2017,73.7,2
796,1965,100,2001,85.5,36
796,2001,85.5,2004,74.1,3
796,2004,74.1,2006,73.9,2
796,2006,73.9,2008,73.4,2
796,2010,74.2,2012,74,2
796,2014,74.7,2016,74.5,2
797,1969,100,2001,85.9,32
797,2001,85.9,2004,71.7,3
797,2006,71.8,2008,70.5,2
797,2008,70.5,2010,70.1,2
797,2010,70.1,2012,69.5,2
797,2014,70.9,2016,70.8,2
798,1972,100,2001,87.5,29
798,2001,87.5,2004,74.8,3
798,2004,74.8,2006,74.8,2
798,2006,74.8,2008,74.3,2
798,2008,74.3,2010,73.4,2
798,2010,73.4,2012,73.2,2
798,2012,73.2,2014,70.4,2
798,2014,70.4,2016,70.3,2
799,1968,100,2001,88.3,33
799,2001,88.3,2004,73.9,3
799,2004,73.9,2006,73.9,2
799,2008,74.8,2010,74.8,2
799,2010,74.8,2012,74.5,2
800,1996,100,2000,99.3,4
800,2000,99.3,2003,96.4,3
800,2003,96.4,2005,74.9,2
800,2008,91.6,2010,85.3,2
800,2010,85.3,2012,82.8,2
800,2012,82.8,2014,81.5,2
800,2014,81.5,2016,77.9,2
801,1994,100,2000,99,6
801,2000,99,2003,96.3,3
801,2003,96.3,2005,94,2
801,2005,94,2006,93.8,1
801,2008,95.3,2010,85.1,2
801,2010,85.1,2012,83.7,2
801,2012,83.7,2014,81.4,2
801,2014,81.4,2016,77.6,2
802,1981,100,2015,70.3,34
802,2015,70.3,2017,70.3,2
803,1984,100,2004,75,20
803,2004,75,2006,72.6,2
803,2009,73.5,2011,71.8,2
803,2013,73.7,2015,73.7,2
803,2015,73.7,2017,73.1,2
804,1961,100,2004,70,43
804,2004,70,2006,70,2
804,2006,70,2008,67.2,2
804,2010,72.2,2012,71.9,2
804,2012,71.9,2014,71.2,2
805,1993,100,2007,74.8,14
805,2007,74.8,2009,70.1,2
805,2013,74.6,2015,74.2,2
805,2015,74.2,2017,74.2,2
806,2007,100,2014,100,7
806,2014,100,2016,98.6,2
807,2000,100,2006,99.9,6
807,2006,99.9,2007,84.9,1
807,2007,84.9,2009,75,2
807,2011,93.2,2013,92.7,2
807,2013,92.7,2015,87.6,2
808,2004,100,2006,100,2
808,2006,100,2007,100,1
808,2007,100,2009,99.8,2
808,2009,99.8,2011,98.5,2
808,2011,98.5,2013,97.9,2
808,2013,97.9,2015,96.9,2
808,2015,96.9,2017,96.9,2
809,2009,100,2012,99.6,3
809,2012,99.6,2014,99.2,2
809,2014,99.2,2016,90.8,2
810,2010,100,2014,100,4
810,2014,100,2016,98.1,2
811,2010,100,2014,100,4
811,2014,100,2016,98,2
812,2012,100,2014,100,2
812,2014,100,2016,98.8,2
813,2006,100,2007,99.2,1
813,2007,99.2,2011,95,4
813,2011,95,2014,95,3
814,2013,100,2014,100,1
814,2014,100,2016,95.6,2
815,2013,100,2014,99.5,1
815,2014,99.5,2016,96.9,2
816,2013,100,2014,100,1
816,2014,100,2016,96.6,2
817,2012,100,2014,100,2
817,2014,100,2016,95.4,2
818,2013,100,2014,100,1
818,2014,100,2016,96.9,2
819,2012,100,2014,100,2
819,2014,100,2016,95.8,2
820,1959,100,2004,69.5,45
820,2006,72.7,2007,69.7,1
820,2009,71.5,2013,70.9,4
820,2013,70.9,2015,69,2
820,2015,69,2017,68.8,2
821,1964,100,2000,69.6,36
821,2000,69.6,2004,65.9,4
821,2006,70.6,2007,70.3,1
821,2007,70.3,2009,69.1,2
821,2011,70.5,2013,68.5,2
821,2013,68.5,2015,65.9,2
821,2015,65.9,2017,65.9,2
822,2007,96.2,2009,95.8,2
822,2009,95.8,2011,91.4,2
822,2011,91.4,2013,84.3,2
822,2013,84.3,2015,81.9,2
822,2015,81.9,2017,77.7,2
823,1965,100,2004,61.3,39
823,2006,72.5,2007,72.5,1
823,2007,72.5,2009,72.5,2
823,2013,73.2,2015,72.9,2
824,1966,100,2006,60,40
824,2007,64.2,2009,61.5,2
824,2013,66.7,2015,65,2
825,1968,100,2000,71.1,32
825,2007,75.3,2009,73.5,2
825,2011,73.8,2013,73.5,2
825,2013,73.5,2015,73.4,2
826,1967,100,2000,71.8,33
826,2000,71.8,2004,71.6,4
826,2006,77.7,2007,74.1,1
826,2009,74.4,2011,74.3,2
826,2011,74.3,2013,74,2
826,2013,74,2015,73.9,2
827,1960,100,2002,52.3,42
827,2006,73.6,2007,73.6,1
827,2007,73.6,2009,73.6,2
827,2009,73.6,2013,73.4,4
827,2015,74,2017,73.7,2
828,2004,74,2006,73.7,2
828,2006,73.7,2007,73.3,1
828,2007,73.3,2009,72.7,2
828,2009,72.7,2011,72.7,2
828,2013,73.9,2015,73.9,2
828,2015,73.9,2017,73.4,2
829,1993,100,2004,67.7,11
829,2006,75,2007,70.9,1
829,2007,70.9,2009,69.6,2
829,2011,70.7,2013,70.5,2
829,2013,70.5,2015,70.3,2
829,2015,70.3,2017,69.1,2
830,1964,100,2004,57.1,40
830,2009,74,2013,74,4
830,2013,74,2015,73.7,2
830,2015,73.7,2017,73.7,2
831,2006,65.3,2007,42.6,1
831,2009,42.7,2011,42.1,2
831,2011,42.1,2013,42.1,2
832,1957,100,2002,49.7,45
832,2007,71.7,2009,71.7,2
832,2009,71.7,2013,71.3,4
832,2013,71.3,2015,70.8,2
832,2015,70.8,2017,70.5,2
833,1957,100,2002,55.5,45
833,2002,55.5,2004,40.2,2
833,2006,65.7,2007,65.7,1
833,2007,65.7,2009,65.7,2
833,2011,66.2,2013,64.9,2
833,2015,65,2017,64.1,2
834,1957,100,2002,56.9,45
834,2006,74,2007,74,1
834,2007,74,2009,74,2
834,2009,74,2013,73.9,4
834,2013,73.9,2015,73.3,2
834,2015,73.3,2017,72,2
835,2004,75,2006,33.1,2
835,2007,99.9,2009,99.9,2
835,2009,99.9,2013,99.8,4
835,2013,99.8,2017,88,4
836,2009,96.6,2011,96.5,2
837,1973,100,2002,40.8,29
837,2004,70.1,2006,58.7,2
837,2006,58.7,2007,51.8,1
838,2010,77.7,2011,77.6,1
839,2006,100,2007,100,1
839,2007,100,2009,99.8,2
839,2011,100,2015,98.4,4
840,1967,100,2004,61,37
840,2006,75,2007,72.9,1
840,2007,72.9,2009,38.5,2
840,2013,66.8,2015,66.1,2
840,2015,66.1,2017,65.8,2
841,1965,100,2000,68.1,35
841,2000,68.1,2004,64.9,4
841,2006,72.9,2007,72.6,1
841,2009,72.8,2011,71.2,2
841,2011,71.2,2013,71.1,2
841,2013,71.1,2015,70.9,2
841,2015,70.9,2017,70.8,2
842,2004,57.9,2006,43.6,2
842,2006,43.6,2007,23,1
842,2009,37.8,2011,35.5,2
842,2011,35.5,2013,35.5,2
843,2006,77.5,2007,50.2,1
843,2007,50.2,2009,48.3,2
843,2009,48.3,2011,44.7,2
843,2011,44.7,2013,44.7,2
844,1977,100,2000,69.9,23
844,2011,72.1,2013,71.7,2
844,2013,71.7,2015,71.1,2
844,2015,71.1,2017,70,2
845,1963,100,2002,56.4,39
845,2009,73.7,2013,73.7,4
845,2013,73.7,2015,73.3,2
845,2015,73.3,2017,73.2,2
846,2001,100,2004,72.6,3
846,2006,99.3,2007,98.9,1
846,2007,98.9,2009,97.1,2
846,2009,97.1,2011,97,2
846,2011,97,2013,96.4,2
846,2013,96.4,2015,93.6,2
846,2015,93.6,2017,81.8,2
847,1978,100,2004,61,26
847,2006,87.5,2007,70,1
847,2007,70,2009,69,2
847,2011,70.4,2013,69.8,2
847,2013,69.8,2015,69.3,2
847,2015,69.3,2017,69.1,2
848,2000,100,2004,75,4
848,2007,99,2009,99,2
848,2009,99,2011,98.3,2
849,1982,100,2000,63,18
849,2006,78.3,2007,77.8,1
849,2007,77.8,2009,70.7,2
849,2009,70.7,2011,70.2,2
849,2011,70.2,2013,69.2,2
849,2013,69.2,2015,67.6,2
849,2015,67.6,2017,66.8,2
850,1965,100,2000,62.1,35
850,2006,70.1,2007,69.9,1
850,2013,71.3,2015,71.2,2
850,2015,71.2,2017,71,2
851,2004,71.3,2006,64.2,2
851,2007,64.3,2009,61.3,2
851,2011,62.9,2013,62.9,2
851,2015,99.4,2017,94.9,2
852,1988,100,2000,74.4,12
852,2007,92.3,2009,90.9,2
852,2009,90.9,2011,80.3,2
852,2011,80.3,2013,76,2
852,2013,76,2015,76,2
852,2015,76,2017,74.6,2
853,1988,100,2000,68.6,12
853,2006,91,2007,90.4,1
853,2007,90.4,2009,90,2
853,2009,90,2011,85.3,2
853,2011,85.3,2013,73.2,2
853,2015,74.4,2017,73.9,2
854,1988,100,2004,59.9,16
854,2006,74.6,2007,70,1
854,2007,70,2009,68.3,2
854,2009,68.3,2011,68.2,2
854,2011,68.2,2013,68,2
854,2013,68,2015,64.3,2
854,2015,64.3,2017,64,2
855,1993,100,2000,73.9,7
855,2000,73.9,2004,64.6,4
855,2007,72.3,2009,72.3,2
855,2011,72.7,2013,72.4,2
855,2013,72.4,2015,71,2
856,1991,100,2000,74.9,9
856,2000,74.9,2004,70.5,4
856,2007,90.7,2009,87.7,2
856,2009,87.7,2011,87.6,2
856,2011,87.6,2013,86,2
856,2013,86,2015,84.9,2
856,2015,84.9,2017,84.8,2
857,1974,100,2004,56.9,30
857,2006,66.6,2007,65.1,1
857,2009,70,2011,69.2,2
857,2013,70.1,2015,63.3,2
858,2004,69.1,2006,6.9,2
858,2006,6.9,2007,6.8,1
858,2013,99.7,2015,98.7,2
859,1976,100,2004,61.7,28
859,2006,75,2007,68.9,1
859,2013,72.4,2015,67.9,2
859,2015,67.9,2017,58,2
860,1983,100,2004,53,21
860,2006,74.2,2007,63.5,1
860,2009,65.2,2011,65.2,2
860,2011,65.2,2013,63.1,2
860,2013,63.1,2015,51.3,2
860,2015,51.3,2017,51.1,2
861,1985,100,2000,73.9,15
861,2000,73.9,2004,65,4
861,2006,76.4,2007,72.7,1
861,2007,72.7,2009,70.7,2
861,2013,72.3,2015,72.2,2
861,2015,72.2,2017,70.4,2
862,1987,100,2004,63,17
862,2006,74.6,2007,72.6,1
862,2009,73.3,2013,72,4
862,2013,72,2015,72,2
862,2015,72,2017,71.8,2
863,1959,100,2004,51.3,45
863,2006,63.1,2007,62.7,1
863,2009,67.1,2011,66.1,2
863,2011,66.1,2013,65.6,2
863,2013,65.6,2015,63.2,2
863,2015,63.2,2017,62.3,2
864,1959,100,2004,66,45
864,2007,70,2009,70,2
864,2011,70.3,2013,69.9,2
864,2013,69.9,2015,69.5,2
864,2015,69.5,2017,69,2
865,2006,68.1,2007,68,1
865,2011,98.5,2013,93.6,2
865,2013,93.6,2015,87.3,2
865,2015,87.3,2017,83.7,2
866,1990,100,2003,74.3,13
866,2003,74.3,2004,74,1
866,2006,76.7,2008,76.1,2
866,2010,88.3,2012,83.6,2
866,2012,83.6,2014,77.4,2
866,2014,77.4,2016,74.5,2
867,1973,100,2003,51.9,30
867,2008,65.1,2010,63.9,2
867,2012,64.5,2014,63.9,2
868,1973,100,2003,54.5,30
868,2008,73.4,2010,73.4,2
868,2010,73.4,2012,72.7,2
868,2012,72.7,2014,72.7,2
868,2014,72.7,2016,72.4,2
869,1970,100,2003,72.7,33
869,2003,72.7,2004,70.1,1
869,2006,75.4,2008,73.3,2
869,2012,74.1,2014,74,2
869,2014,74,2016,73.3,2
870,2008,74.5,2010,74.1,2
870,2012,74.3,2014,74,2
871,1974,100,2003,71.5,29
871,2008,74.7,2010,73.9,2
871,2010,73.9,2012,73.9,2
871,2012,73.9,2014,69.7,2
871,2014,69.7,2016,69.5,2
872,1956,100,2002,50.7,46
872,2002,50.7,2004,50.6,2
872,2006,71.7,2007,71.1,1
872,2007,71.1,2009,71.1,2
872,2009,71.1,2013,71.1,4
872,2013,71.1,2015,70.7,2
872,2015,70.7,2017,70,2
873,1992,100,2000,73.5,8
873,2000,73.5,2004,72.3,4
873,2007,83.4,2009,82.5,2
873,2009,82.5,2011,80.1,2
873,2011,80.1,2013,80,2
873,2013,80,2015,77.9,2
873,2015,77.9,2017,73.6,2
874,1990,100,2000,74.1,10
874,2000,74.1,2004,73.5,4
874,2006,83.6,2007,83.2,1
874,2007,83.2,2009,83.2,2
874,2009,83.2,2011,80.8,2
874,2011,80.8,2013,78,2
874,2013,78,2015,76.1,2
874,2015,76.1,2017,73.5,2
875,1970,100,2000,70.7,30
875,2000,70.7,2004,65.7,4
875,2006,80.2,2007,74.3,1
875,2007,74.3,2009,71.9,2
875,2009,71.9,2011,70.8,2
875,2011,70.8,2013,70.7,2
875,2013,70.7,2015,70.3,2
875,2015,70.3,2017,70,2
876,1979,100,2003,73.3,24
876,2006,74.6,2008,74.3,2
876,2008,74.3,2010,73.8,2
876,2010,73.8,2012,73.5,2
876,2014,73.8,2016,73.8,2
877,1979,100,2003,40.1,24
877,2008,65.1,2010,64.2,2
877,2014,66.2,2016,65.6,2
878,1958,100,2002,50.4,44
878,2006,70.7,2007,69.6,1
878,2009,71.2,2013,70.9,4
878,2013,70.9,2015,70.2,2
878,2015,70.2,2017,69.8,2
879,1992,100,2000,73.6,8
879,2006,83.6,2007,78.9,1
879,2007,78.9,2009,75.1,2
879,2009,75.1,2011,74.5,2
879,2011,74.5,2013,74.2,2
879,2013,74.2,2015,74.2,2
879,2015,74.2,2017,74.1,2
880,1972,100,2000,69.6,28
880,2000,69.6,2004,69.3,4
880,2006,74,2007,73.4,1
880,2009,73.8,2011,73.1,2
880,2011,73.1,2013,73.1,2
880,2013,73.1,2015,72.8,2
880,2015,72.8,2017,72.8,2
881,1972,100,2000,70.2,28
881,2006,74.3,2007,73.8,1
881,2009,74,2011,71,2
881,2011,71,2013,71,2
881,2015,72.1,2017,71.2,2
882,1971,100,2000,70.5,29
882,2006,85.2,2007,81.8,1
882,2007,81.8,2009,74.4,2
882,2009,74.4,2011,72.6,2
882,2011,72.6,2013,72.6,2
882,2013,72.6,2015,72.4,2
882,2015,72.4,2017,71.9,2
883,1981,100,2000,70.8,19
883,2000,70.8,2004,69.4,4
883,2004,69.4,2006,68.6,2
883,2009,71.8,2011,71.5,2
883,2011,71.5,2013,71.2,2
883,2013,71.2,2015,70.4,2
884,2006,74.3,2007,73.3,1
884,2011,99.8,2013,97.8,2
884,2013,97.8,2015,93.5,2
884,2015,93.5,2017,87.8,2
885,2011,99.7,2013,97.4,2
885,2013,97.4,2015,92.8,2
885,2015,92.8,2017,86.9,2
886,2006,72,2007,65.9,1
886,2011,100,2013,95.1,2
886,2013,95.1,2015,92.1,2
886,2015,92.1,2017,87.9,2
887,1973,100,2003,60.6,30
887,2003,60.6,2004,58.9,1
887,2006,68.3,2008,63.6,2
887,2008,63.6,2010,63,2
887,2010,63,2012,61.6,2
887,2014,62.3,2016,61.9,2
888,1937,100,2000,58.4,63
888,2006,69,2007,66.9,1
888,2009,68.7,2011,66.1,2
888,2011,66.1,2013,66.1,2
888,2013,66.1,2015,65.8,2
888,2015,65.8,2017,65.4,2
889,1970,100,2000,71.8,30
889,2000,71.8,2004,65.8,4
889,2006,75,2007,74.9,1
889,2007,74.9,2009,74.9,2
889,2009,74.9,2011,74.8,2
889,2011,74.8,2013,74.8,2
889,2013,74.8,2015,74.7,2
889,2015,74.7,2017,74.6,2
890,1985,100,2000,73.6,15
890,2000,73.6,2004,71.3,4
890,2006,90.1,2007,88.7,1
890,2009,90.5,2011,88.1,2
890,2011,88.1,2013,86.8,2
890,2013,86.8,2015,82,2
890,2015,82,2017,77.2,2
891,1967,100,2004,70.8,37
891,2004,70.8,2006,62.9,2
891,2006,62.9,2007,62,1
891,2007,62,2009,61.4,2
891,2011,62.6,2013,62.1,2
891,2013,62.1,2015,60.8,2
891,2015,60.8,2017,60.3,2
892,1973,100,2003,57.8,30
892,2003,57.8,2004,52.6,1
892,2008,64.8,2010,64.6,2
892,2012,65.9,2014,62.3,2
892,2014,62.3,2016,62.2,2
893,1995,100,2000,72.9,5
893,2007,96.6,2009,96.4,2
893,2009,96.4,2011,92.6,2
893,2011,92.6,2013,84.7,2
893,2013,84.7,2015,84.5,2
893,2015,84.5,2017,76.5,2
894,2004,29.8,2006,3.7,2
894,2006,3.7,2007,3.4,1
894,2009,99.7,2013,98.9,4
894,2013,98.9,2017,89.8,4
895,2004,65.4,2006,54.5,2
895,2009,57.6,2011,57.2,2
895,2011,57.2,2013,56.3,2
895,2013,56.3,2015,8.9,2
896,1959,100,2002,42.7,43
896,2002,42.7,2004,41,2
896,2006,47.7,2007,47.5,1
896,2009,48.1,2011,47.5,2
896,2011,47.5,2013,46.5,2
896,2013,46.5,2015,46.3,2
896,2015,46.3,2017,45.7,2
897,1973,100,2003,59.6,30
897,2006,70.7,2008,67.6,2
897,2008,67.6,2010,67.3,2
897,2010,67.3,2012,65.3,2
897,2012,65.3,2014,63.5,2
898,1995,100,2000,72.7,5
898,2006,92.2,2007,90.9,1
898,2009,93.9,2011,90.7,2
898,2013,90.8,2015,90.7,2
898,2015,90.7,2017,76.5,2
899,1969,100,2000,64.2,31
899,2000,64.2,2004,63.1,4
899,2009,72,2011,71.8,2
899,2011,71.8,2013,71.7,2
899,2015,72.3,2017,70.8,2
900,1995,100,2000,72.8,5
900,2009,95.4,2011,90.5,2
900,2011,90.5,2013,86.2,2
900,2013,86.2,2015,86.1,2
900,2015,86.1,2017,78.1,2
901,1921,100,2000,42.6,79
901,2000,42.6,2004,41.9,4
901,2006,53.9,2007,53.4,1
901,2007,53.4,2009,53.3,2
901,2009,53.3,2011,51,2
901,2013,52,2015,48.5,2
901,2015,48.5,2017,44.7,2
902,1937,100,2000,67.6,63
902,2000,67.6,2004,62.7,4
902,2004,62.7,2006,57.1,2
902,2007,68.4,2009,66.3,2
902,2009,66.3,2011,65.4,2
902,2011,65.4,2013,60.5,2
902,2015,61.3,2017,59.7,2
903,2006,97.3,2008,97.1,2
903,2010,97.6,2012,97.5,2
903,2012,97.5,2014,97.4,2
903,2014,97.4,2016,85,2
904,2006,74.5,2007,52.8,1
904,2009,52.9,2011,39.2,2
904,2011,39.2,2013,36.1,2
905,1985,100,2004,54.9,19
905,2006,74.4,2007,73.4,1
905,2013,74.6,2015,74.6,2
905,2015,74.6,2017,73.7,2
906,1962,100,2002,66.4,40
906,2006,94.2,2007,69,1
906,2007,69,2009,69,2
906,2009,69,2011,68.8,2
906,2011,68.8,2013,68.8,2
906,2015,69.7,2017,68.7,2
907,1964,100,2003,63.8,39
907,2008,67.6,2010,67.3,2
907,2010,67.3,2012,66.7,2
907,2012,66.7,2014,66.5,2
907,2014,66.5,2016,65.9,2
908,1954,100,2002,37.1,48
908,2004,59.6,2006,55.5,2
908,2006,55.5,2007,54.4,1
908,2009,54.5,2011,54.1,2
908,2013,57,2015,53.5,2
909,1977,100,2004,49.3,27
909,2006,55.2,2007,53.8,1
909,2009,59.6,2011,56.6,2
909,2011,56.6,2013,53.7,2
909,2013,53.7,2015,51,2
909,2015,51,2017,49,2
910,1978,100,2004,63.8,26
910,2006,72.1,2007,67.7,1
910,2007,67.7,2009,67.7,2
910,2009,67.7,2011,66.8,2
910,2011,66.8,2013,66.8,2
910,2015,67.2,2017,66.5,2
911,1978,100,2004,56.5,26
911,2006,71.8,2007,67.7,1
911,2007,67.7,2009,64.9,2
911,2011,67.5,2013,67.4,2
911,2013,67.4,2015,67.4,2
911,2015,67.4,2017,65.3,2
912,1958,100,2002,53.5,44
912,2009,73.5,2013,73.5,4
912,2013,73.5,2015,72.9,2
912,2015,72.9,2017,72,2
913,1994,100,2000,74.7,6
913,2000,74.7,2004,70.3,4
913,2007,94.1,2009,93,2
913,2011,93.5,2013,89.2,2
913,2015,89.3,2017,76.1,2
914,2004,69.6,2006,59.8,2
914,2011,98.8,2013,98.4,2
914,2013,98.4,2015,96.8,2
914,2015,96.8,2017,90.6,2
915,1988,100,2004,66.5,16
915,2006,87.6,2007,83.1,1
915,2007,83.1,2009,70.6,2
915,2011,71.6,2013,67.3,2
915,2013,67.3,2015,53.2,2
915,2015,53.2,2017,48.9,2
916,1937,100,2004,44.2,67
916,2006,63.5,2007,62.7,1
916,2009,63.9,2011,62.8,2
916,2011,62.8,2013,60.6,2
916,2013,60.6,2015,59.5,2
916,2015,59.5,2017,56.9,2
917,1949,100,2002,44.5,53
917,2006,60.8,2007,54,1
917,2007,54,2009,54,2
917,2009,54,2011,53.9,2
917,2011,53.9,2013,53.6,2
917,2013,53.6,2015,53.2,2
917,2015,53.2,2017,53.2,2
918,1995,100,2000,72.5,5
918,2000,72.5,2004,68.9,4
918,2006,92.3,2007,77.5,1
918,2007,77.5,2009,73.9,2
918,2009,73.9,2011,73.9,2
918,2011,73.9,2013,73.6,2
918,2013,73.6,2015,73.1,2
918,2015,73.1,2017,72.9,2
919,1949,100,2004,52.2,55
919,2007,72.9,2009,68.8,2
919,2009,68.8,2011,68.3,2
919,2011,68.3,2013,68,2
920,1958,100,2002,75,44
920,2002,75,2004,75,2
920,2006,99.4,2007,71.5,1
920,2007,71.5,2009,71.5,2
920,2009,71.5,2011,71.5,2
920,2013,72.3,2015,71.5,2
920,2015,71.5,2017,71.4,2
921,1949,100,2004,50.6,55
921,2006,73.5,2007,72.6,1
921,2009,73.5,2013,72.8,4
921,2013,72.8,2015,72.3,2
921,2015,72.3,2017,68.9,2
922,1990,100,2002,55,12
922,2002,55,2004,50.6,2
922,2006,69,2007,47.6,1
922,2015,74.4,2017,74.2,2
923,1961,100,2002,61.6,41
923,2006,72,2007,71.8,1
923,2013,72.6,2015,72.1,2
923,2015,72.1,2017,72,2
924,1949,100,2004,54.8,55
924,2006,61.1,2007,61.1,1
924,2009,68.9,2011,65.1,2
924,2013,65.4,2015,63.1,2
924,2015,63.1,2017,49.8,2
925,1962,100,2002,35.4,40
925,2004,35.7,2006,0.6,2
925,2009,53.2,2011,52.7,2
925,2011,52.7,2013,50.9,2
925,2013,50.9,2015,50.9,2
925,2015,50.9,2017,49.7,2
926,1962,100,2002,35.9,40
926,2002,35.9,2004,35.6,2
926,2006,70.5,2007,68.6,1
926,2009,70.7,2011,68.2,2
926,2011,68.2,2013,66.4,2
926,2013,66.4,2015,64,2
926,2015,64,2017,63.6,2
927,1965,100,2004,62.9,39
927,2006,64.9,2007,63.9,1
927,2009,68.9,2011,67.6,2
927,2011,67.6,2013,67.4,2
927,2013,67.4,2015,66.7,2
927,2015,66.7,2017,65.2,2
928,1961,100,2002,34.9,41
928,2006,73.8,2007,73.6,1
928,2007,73.6,2009,71,2
928,2013,72.3,2015,70.5,2
928,2015,70.5,2017,70.5,2
929,2006,75,2007,31,1
929,2007,31,2009,25.7,2
929,2011,26.7,2013,26.7,2
930,1998,100,2004,68,6
930,2006,75,2007,71.1,1
930,2007,71.1,2009,70.9,2
930,2009,70.9,2011,70.1,2
930,2011,70.1,2013,70.1,2
930,2013,70.1,2015,70.1,2
930,2015,70.1,2017,69.9,2
931,1937,100,2002,41.9,65
931,2006,74,2007,73,1
931,2007,73,2009,73,2
931,2009,73,2013,72.9,4
931,2013,72.9,2015,72.8,2
931,2015,72.8,2017,72.6,2
932,1993,100,2002,45.8,9
932,2004,69.7,2006,64.5,2
932,2006,64.5,2007,62.4,1
932,2007,62.4,2009,62.4,2
932,2009,62.4,2011,62.4,2
932,2011,62.4,2013,55.5,2
932,2013,55.5,2015,54.6,2
932,2015,54.6,2017,54.1,2
933,1993,100,2002,50.1,9
933,2004,69.7,2006,61.1,2
933,2006,61.1,2007,60.9,1
933,2007,60.9,2009,60.9,2
933,2009,60.9,2011,60.9,2
933,2011,60.9,2013,56.4,2
933,2013,56.4,2015,54.7,2
933,2015,54.7,2017,54.7,2
934,1993,100,2002,47.1,9
934,2006,72,2007,44.8,1
934,2009,47,2011,46.9,2
934,2011,46.9,2013,44.8,2
934,2013,44.8,2015,42.3,2
934,2015,42.3,2017,42.3,2
935,1963,100,2002,43.9,39
935,2006,73.3,2007,73.3,1
935,2013,74.7,2015,73.6,2
935,2015,73.6,2017,73.5,2
936,1949,100,2002,42.1,53
936,2004,60.2,2006,48.7,2
936,2009,69.6,2011,69.3,2
936,2011,69.3,2013,68.9,2
936,2013,68.9,2015,68.5,2
936,2015,68.5,2017,68.2,2
937,1937,100,2002,40,65
937,2004,72.6,2006,71,2
937,2006,71,2007,70.7,1
937,2009,74.8,2013,73.5,4
937,2013,73.5,2015,72.5,2
938,2006,72.5,2007,66.6,1
938,2007,66.6,2009,63.6,2
938,2009,63.6,2011,59,2
938,2011,59,2013,55.6,2
939,1967,100,2004,54.9,37
939,2006,72.8,2007,58.4,1
939,2009,60.4,2011,57.3,2
939,2011,57.3,2013,56.5,2
939,2015,74.9,2017,74.5,2
940,1949,100,2004,67.8,55
940,2006,69.4,2007,63.7,1
940,2007,63.7,2009,63.7,2
940,2009,63.7,2011,61.8,2
940,2011,61.8,2013,58.9,2
940,2015,59.5,2017,59.5,2
941,1946,100,2003,74.8,57
941,2003,74.8,2004,74,1
941,2004,74,2006,69.6,2
941,2006,69.6,2008,69.6,2
941,2008,69.6,2010,69.6,2
941,2014,71.8,2016,71.3,2
942,1998,100,2003,99.7,5
942,2003,99.7,2004,98.3,1
942,2004,98.3,2006,98.1,2
942,2006,98.1,2008,98,2
942,2008,98,2010,97.8,2
943,1998,100,2003,75,5
943,2003,75,2004,75,1
943,2006,98.5,2008,98.3,2
944,2001,100,2003,75.7,2
944,2003,75.7,2004,73.9,1
944,2006,99,2008,97.1,2
944,2008,97.1,2010,96.5,2
945,2003,66.7,2004,61.6,1
945,2004,61.6,2006,31.5,2
945,2006,31.5,2008,15,2
945,2008,15,2010,13,2
945,2012,99.6,2016,94.4,4
946,1981,100,2004,42.6,23
946,2004,42.6,2006,42.3,2
946,2008,42.6,2010,42.5,2
946,2010,42.5,2012,40,2
946,2012,40,2014,39.8,2
946,2014,39.8,2016,39.8,2
947,2000,100,2009,95.9,9
947,2009,95.9,2011,94.6,2
947,2011,94.6,2013,91.7,2
947,2013,91.7,2015,88.2,2
947,2015,88.2,2017,79.3,2
948,2000,100,2009,96.3,9
948,2009,96.3,2011,94.9,2
948,2011,94.9,2013,92.3,2
948,2013,92.3,2015,88.3,2
948,2015,88.3,2017,79.1,2
949,2000,100,2009,97.8,9
949,2009,97.8,2011,97.1,2
949,2011,97.1,2013,95.5,2
949,2013,95.5,2015,93.9,2
949,2015,93.9,2017,82.1,2
950,2000,100,2009,97.9,9
950,2009,97.9,2011,97.1,2
950,2011,97.1,2013,95.5,2
950,2013,95.5,2015,93.8,2
950,2015,93.8,2017,81.6,2
951,2000,100,2009,97,9
951,2009,97,2011,95.6,2
951,2011,95.6,2013,92.8,2
951,2013,92.8,2015,89.9,2
951,2015,89.9,2017,80,2
952,2000,100,2009,96.6,9
952,2009,96.6,2011,95.5,2
952,2011,95.5,2013,92.6,2
952,2013,92.6,2015,89,2
952,2015,89,2017,78.9,2
953,2000,100,2009,96.2,9
953,2009,96.2,2011,94.4,2
953,2011,94.4,2013,92.8,2
953,2013,92.8,2015,92.7,2
953,2015,92.7,2017,80.6,2
954,2000,100,2009,96.5,9
954,2009,96.5,2011,94.5,2
954,2011,94.5,2013,92.8,2
954,2013,92.8,2015,92.5,2
954,2015,92.5,2017,79.4,2
955,2000,100,2009,97.3,9
955,2009,97.3,2011,95.4,2
955,2011,95.4,2013,94.9,2
955,2013,94.9,2015,92.2,2
955,2015,92.2,2017,80.8,2
956,2000,100,2009,97.3,9
956,2009,97.3,2011,95,2
956,2011,95,2013,94.2,2
956,2013,94.2,2015,92.1,2
956,2015,92.1,2017,89.9,2
957,2005,100,2009,100,4
957,2009,100,2011,98.1,2
957,2013,98.2,2015,97.6,2
957,2015,97.6,2017,85.5,2
958,2005,100,2009,100,4
958,2009,100,2011,98.3,2
958,2011,98.3,2013,98.2,2
958,2013,98.2,2015,97.6,2
958,2015,97.6,2017,85.8,2
959,2006,100,2009,97.6,3
959,2009,97.6,2011,96.3,2
959,2011,96.3,2013,96.3,2
959,2013,96.3,2015,96.2,2
959,2015,96.2,2017,84.8,2
960,2006,100,2009,96,3
960,2011,96.3,2013,95.9,2
960,2013,95.9,2015,95.3,2
960,2015,95.3,2017,84.4,2
961,2005,100,2009,99.9,4
961,2009,99.9,2013,99.7,4
961,2013,99.7,2017,87.8,4
962,1944,100,2006,67.9,62
962,2007,70.7,2009,70.2,2
962,2009,70.2,2013,69.5,4
962,2013,69.5,2015,68.7,2
962,2015,68.7,2017,64.2,2
963,1944,100,2006,62.2,62
963,2007,63.7,2009,63.7,2
963,2011,66.5,2013,63.7,2
963,2013,63.7,2015,63.7,2
963,2015,63.7,2017,63.3,2
964,2005,100,2009,99.8,4
964,2009,99.8,2013,95.9,4
964,2013,95.9,2017,85.6,4
965,2005,100,2009,100,4
965,2009,100,2013,96,4
965,2013,96,2017,85.5,4
966,2005,100,2007,100,2
966,2007,100,2009,100,2
966,2009,100,2013,99.1,4
966,2013,99.1,2017,87.6,4
967,2000,100,2009,96.9,9
967,2009,96.9,2013,94.5,4
967,2013,94.5,2017,80.2,4
968,1983,100,2014,72,31
969,1941,100,2003,46.1,62
969,2003,46.1,2004,46.1,1
969,2007,69.9,2009,69.3,2
969,2009,69.3,2011,66.4,2
969,2011,66.4,2013,57.5,2
969,2013,57.5,2015,54.6,2
969,2015,54.6,2016,54.3,1
969,2016,54.3,2017,54.1,1
970,1972,100,2003,47.6,31
970,2003,47.6,2004,45.2,1
970,2007,74.4,2009,73.1,2
970,2009,73.1,2011,73,2
970,2011,73,2013,69.6,2
970,2015,70.3,2017,69,2
971,1998,100,2003,79.9,5
971,2003,79.9,2004,73.5,1
971,2007,97,2009,96.5,2
971,2009,96.5,2011,96.3,2
971,2011,96.3,2013,93.3,2
971,2013,93.3,2015,93.1,2
971,2015,93.1,2017,79.2,2
972,2003,40.9,2004,40.5,1
972,2004,40.5,2006,40.5,2
972,2009,63.1,2011,63.1,2
972,2013,98.7,2015,97.1,2
972,2015,97.1,2017,88.3,2
973,2003,56.2,2004,54.8,1
973,2007,72.2,2009,71.9,2
973,2009,71.9,2011,71.9,2
973,2013,99.5,2015,98.4,2
973,2015,98.4,2017,92.5,2
974,2003,53.4,2004,53.1,1
974,2013,98,2015,97.2,2
974,2015,97.2,2017,90.4,2
975,2003,46.1,2004,43.2,1
975,2009,57.1,2011,55.4,2
975,2013,98.7,2015,96.5,2
975,2015,96.5,2017,90.4,2
976,2003,33.3,2004,32.6,1
976,2007,58.1,2009,56.8,2
976,2009,56.8,2011,56.8,2
976,2013,99.2,2015,98.4,2
976,2015,98.4,2017,92.2,2
977,2001,99.5,2003,99.2,2
977,2003,99.2,2005,99.2,2
977,2005,99.2,2007,98.2,2
977,2007,98.2,2009,97.9,2
977,2009,97.9,2011,97.8,2
977,2011,97.8,2013,95.7,2
977,2013,95.7,2015,95,2
977,2015,95,2017,81,2
978,1999,100,2001,93.8,2
978,2003,99.8,2005,99.3,2
978,2005,99.3,2007,98.5,2
978,2009,98.6,2011,93.7,2
978,2011,93.7,2013,91.2,2
978,2013,91.2,2015,89.4,2
978,2015,89.4,2017,78.6,2
979,2001,27.1,2006,27.1,5
979,2007,99.8,2009,99.8,2
979,2009,99.8,2011,96.6,2
979,2011,96.6,2013,96.3,2
979,2013,96.3,2015,96.1,2
979,2015,96.1,2017,84.6,2
980,1961,100,2003,49.6,42
980,2003,49.6,2004,47.7,1
980,2009,57,2011,56.5,2
980,2015,64.8,2017,64.6,2
981,1978,100,2003,70.8,25
981,2003,70.8,2004,70,1
981,2009,73.8,2011,73.6,2
981,2011,73.6,2013,72.8,2
981,2013,72.8,2015,72.6,2
981,2015,72.6,2017,72.5,2
982,1999,100,2001,92.1,2
982,2001,92.1,2003,91.2,2
982,2005,91.6,2007,90.8,2
982,2009,99,2011,95.8,2
982,2011,95.8,2013,95.7,2
982,2013,95.7,2015,94.1,2
982,2015,94.1,2017,79.8,2
983,2005,88.3,2007,87.7,2
983,2009,99.1,2011,97.6,2
983,2011,97.6,2013,97.5,2
983,2013,97.5,2015,97.2,2
983,2015,97.2,2017,84.6,2
984,1991,100,2001,73.3,10
984,2003,74.7,2005,74.6,2
984,2007,92.2,2009,90.3,2
984,2009,90.3,2011,87.2,2
984,2011,87.2,2013,82.8,2
984,2013,82.8,2015,77.4,2
984,2015,77.4,2017,74.5,2
985,1985,100,2001,68.7,16
985,2003,77.1,2005,76.4,2
985,2005,76.4,2007,74.2,2
985,2007,74.2,2009,73.9,2
985,2011,76.3,2013,76.1,2
985,2013,76.1,2015,75.6,2
985,2015,75.6,2017,74.3,2
986,1975,100,2001,72,26
986,2003,72.8,2005,72.8,2
986,2005,72.8,2007,72.8,2
986,2007,72.8,2009,72.6,2
986,2011,73.1,2013,72.6,2
986,2013,72.6,2015,72.1,2
986,2015,72.1,2017,72,2
987,1962,100,2003,53.9,41
987,2003,53.9,2004,53.2,1
987,2007,70,2009,68.5,2
987,2011,69.4,2013,65.6,2
988,1981,100,2003,73.5,22
988,2003,73.5,2004,64.8,1
988,2004,64.8,2006,64.2,2
988,2011,75.3,2013,74.9,2
988,2013,74.9,2015,73.7,2
988,2015,73.7,2017,73.4,2
989,2003,52.3,2004,44.8,1
989,2007,62,2009,61.2,2
989,2009,61.2,2011,61.2,2
989,2013,99,2015,97.1,2
989,2015,97.1,2017,90.9,2
990,1998,100,2003,88.8,5
990,2003,88.8,2004,74.4,1
990,2009,98.8,2011,91.4,2
990,2013,91.9,2015,91.6,2
990,2015,91.6,2017,84.8,2
991,1984,100,2003,72.7,19
991,2004,72.8,2006,71.7,2
991,2007,74.9,2009,74.1,2
991,2009,74.1,2011,74.1,2
991,2011,74.1,2013,73.9,2
991,2013,73.9,2015,73.9,2
991,2015,73.9,2017,73.8,2
992,1983,100,2003,71.7,20
992,2003,71.7,2004,71.7,1
992,2006,72.8,2007,68.8,1
992,2007,68.8,2009,67.9,2
992,2009,67.9,2011,67.7,2
992,2013,69.1,2015,62.9,2
992,2015,62.9,2017,62.9,2
993,1983,100,2003,72.3,20
993,2003,72.3,2004,72.3,1
993,2004,72.3,2006,70.9,2
993,2006,70.9,2007,63.5,1
993,2007,63.5,2009,61.1,2
993,2013,62.6,2015,62.1,2
993,2015,62.1,2017,61.1,2
994,1982,100,2003,71.1,21
994,2003,71.1,2004,71.1,1
994,2004,71.1,2006,70.7,2
994,2007,74.9,2009,74.6,2
994,2009,74.6,2011,74.6,2
994,2011,74.6,2013,74.3,2
994,2013,74.3,2015,74.2,2
994,2015,74.2,2017,73.8,2
995,1984,100,2003,72.2,19
995,2003,72.2,2004,72.2,1
995,2007,74.8,2009,74.3,2
995,2011,74.6,2013,74.5,2
995,2013,74.5,2015,74.5,2
995,2015,74.5,2017,74.1,2
996,1984,100,2003,72.4,19
996,2003,72.4,2004,72.4,1
996,2007,74.8,2009,74.2,2
996,2011,74.6,2013,74.3,2
996,2013,74.3,2015,73.8,2
996,2015,73.8,2017,73.8,2
997,1985,100,2003,75,18
997,2003,75,2005,75,2
997,2005,75,2007,75,2
997,2007,75,2009,75,2
997,2009,75,2011,74.8,2
997,2011,74.8,2015,74.4,4
997,2015,74.4,2017,72.7,2
998,1970,100,2003,69.9,33
998,2003,69.9,2005,69.7,2
998,2005,69.7,2007,68.5,2
998,2009,68.7,2011,68,2
998,2011,68,2013,66.5,2
998,2013,66.5,2015,65.2,2
998,2015,65.2,2017,63.4,2
999,1960,100,2003,74.3,43
999,2003,74.3,2005,73.2,2
999,2005,73.2,2007,71.3,2
999,2013,72.4,2015,71.9,2
999,2015,71.9,2017,69.8,2
1000,1960,100,2003,75,43
1000,2003,75,2005,75,2
1000,2005,75,2007,70,2
1000,2007,70,2009,70,2
1000,2009,70,2011,57.5,2
1000,2011,57.5,2013,57.2,2
1000,2013,57.2,2015,57.2,2
1000,2015,57.2,2017,55.9,2
1001,1960,100,2003,75,43
1001,2003,75,2005,75,2
1001,2005,75,2007,74.2,2
1001,2007,74.2,2009,50.9,2
1001,2009,50.9,2011,49.7,2
1001,2011,49.7,2013,49.1,2
1001,2013,49.1,2015,48,2
1001,2015,48,2017,46.9,2
1002,2003,73.5,2005,68.9,2
1002,2009,99.7,2013,99,4
1002,2013,99,2017,87.1,4
1003,2007,99.8,2009,99.2,2
1003,2009,99.2,2011,95.8,2
1004,2003,100,2005,75,2
1004,2007,99.5,2009,99.2,2
1004,2009,99.2,2011,96.8,2
1005,2003,100,2005,75,2
1005,2007,100,2009,97.7,2
1005,2009,97.7,2011,97.7,2
1006,1960,100,2003,73.3,43
1006,2003,73.3,2005,72.8,2
1006,2005,72.8,2006,61.5,1
1006,2007,72.8,2009,68.7,2
1006,2009,68.7,2011,68.6,2
1006,2011,68.6,2013,66.6,2
1006,2013,66.6,2015,65.5,2
1006,2015,65.5,2017,64,2
1007,1985,100,2003,69.5,18
1007,2004,72.4,2006,72.2,2
1007,2006,72.2,2007,72.2,1
1007,2007,72.2,2009,66.7,2
1007,2009,66.7,2011,66.5,2
1007,2013,74.4,2015,74.2,2
1007,2015,74.2,2017,73.1,2
1008,1990,100,2003,70.6,13
1008,2004,70.7,2006,68.4,2
1008,2006,68.4,2007,68.4,1
1008,2007,68.4,2009,68.3,2
1008,2011,68.4,2013,68.3,2
1008,2013,68.3,2015,68.3,2
1008,2015,68.3,2017,64.5,2
1009,2004,66.6,2006,46,2
1009,2006,46,2007,46,1
1009,2007,46,2009,46,2
1009,2009,46,2011,45.9,2
1009,2011,45.9,2013,41.9,2
1010,1950,100,2003,75,53
1010,2003,75,2004,75,1
1010,2004,75,2006,73.6,2
1010,2006,73.6,2007,73.6,1
1010,2007,73.6,2009,73.6,2
1010,2009,73.6,2011,73.4,2
1010,2011,73.4,2015,73.1,4
1010,2015,73.1,2017,73.1,2
1011,1950,100,2003,75,53
1011,2003,75,2004,75,1
1011,2004,75,2006,74.1,2
1011,2006,74.1,2007,73.7,1
1011,2007,73.7,2009,73.7,2
1011,2009,73.7,2011,73.5,2
1011,2011,73.5,2015,73.5,4
1011,2015,73.5,2017,72.9,2
1012,1950,100,2003,75,53
1012,2003,75,2004,75,1
1012,2004,75,2006,73.5,2
1012,2006,73.5,2007,73.5,1
1012,2007,73.5,2009,71.2,2
1012,2009,71.2,2011,71,2
1012,2011,71,2013,69.6,2
1012,2013,69.6,2015,69.3,2
1012,2015,69.3,2017,69.3,2
1013,2003,40.4,2004,40.4,1
1013,2006,70.3,2007,58.8,1
1013,2007,58.8,2009,58.8,2
1013,2009,58.8,2011,56.9,2
1013,2013,99.8,2015,99.5,2
1014,1978,100,2003,71.8,25
1014,2003,71.8,2004,69.5,1
1014,2006,72.8,2007,54.4,1
1014,2007,54.4,2009,54.3,2
1014,2009,54.3,2011,53.6,2
1014,2013,54.5,2015,54.4,2
1014,2015,54.4,2017,54.4,2
1015,1978,100,2003,71.5,25
1015,2006,73.6,2007,67.9,1
1015,2007,67.9,2009,67.8,2
1015,2009,67.8,2011,67.5,2
1015,2011,67.5,2013,65.2,2
1015,2013,65.2,2015,64.4,2
1015,2015,64.4,2017,64.4,2
1016,1978,100,2003,72.6,25
1016,2003,72.6,2004,71.9,1
1016,2006,72,2007,63.3,1
1016,2007,63.3,2009,61.4,2
1016,2009,61.4,2011,60.7,2
1016,2011,60.7,2013,60.5,2
1016,2013,60.5,2015,60.3,2
1016,2015,60.3,2017,60.3,2
1017,2003,73.4,2004,11.6,1
1017,2004,11.6,2006,11.2,2
1017,2009,90.1,2011,88.7,2
1018,2003,59.9,2004,57.2,1
1018,2006,57.3,2007,32.4,1
1018,2007,32.4,2009,32.2,2
1018,2009,32.2,2011,30.9,2
1018,2011,30.9,2013,30.9,2
1019,2003,73.8,2004,36.3,1
1019,2006,54.9,2007,47.7,1
1019,2009,100,2011,97.4,2
1020,2003,73.4,2004,69.8,1
1020,2004,69.8,2006,59.9,2
1020,2007,67.6,2009,67.5,2
1020,2009,67.5,2011,66.6,2
1020,2011,66.6,2013,66.6,2
1021,2003,71.1,2004,70.7,1
1021,2004,70.7,2006,55.5,2
1021,2007,68.7,2009,67.4,2
1021,2009,67.4,2011,67.2,2
1021,2013,99,2015,99,2
1022,2003,13.8,2006,13.8,3
1022,2007,41.6,2009,41.6,2
1022,2009,41.6,2011,40.6,2
1022,2011,40.6,2013,23.6,2
1023,1994,100,2003,74.7,9
1023,2003,74.7,2005,73.7,2
1023,2005,73.7,2007,73.6,2
1023,2007,73.6,2009,73.6,2
1023,2009,73.6,2013,72.2,4
1023,2013,72.2,2015,72.1,2
1023,2015,72.1,2017,72,2
1024,1978,100,2007,70,29
1024,2007,70,2009,64.6,2
1024,2011,64.7,2013,62.3,2
1024,2013,62.3,2015,62.3,2
1024,2015,62.3,2017,62.3,2
1025,2003,20.1,2004,18.3,1
1025,2007,29.6,2009,29.5,2
1025,2011,99.6,2013,98.7,2
1025,2013,98.7,2015,98.5,2
1025,2015,98.5,2017,91.6,2
1026,1984,100,2003,63.3,19
1026,2003,63.3,2004,63.3,1
1026,2009,74.6,2011,73.8,2
1026,2011,73.8,2013,73.7,2
1026,2013,73.7,2015,73.4,2
1026,2015,73.4,2017,73.1,2
1027,1976,100,2003,73.5,27
1027,2003,73.5,2004,68.6,1
1027,2007,75,2009,75,2
1027,2009,75,2011,72.4,2
1027,2011,72.4,2015,72.1,4
1027,2015,72.1,2017,72.1,2
1028,1958,100,2003,19.5,45
1028,2003,19.5,2004,19.3,1
1028,2011,63.1,2013,62.7,2
1028,2013,62.7,2015,61.5,2
1028,2015,61.5,2016,61.5,1
1028,2016,61.5,2017,61.5,1
1029,1988,100,2003,74.7,15
1029,2003,74.7,2004,74.7,1
1029,2009,79.3,2011,76,2
1029,2011,76,2013,75.8,2
1029,2013,75.8,2015,75.5,2
1029,2015,75.5,2017,75.3,2
1030,1982,100,2003,70.8,21
1030,2003,70.8,2004,70.8,1
1030,2007,75,2009,71.7,2
1030,2011,74.9,2015,71.6,4
1030,2015,71.6,2017,70.6,2
1031,1960,100,2003,72.2,43
1031,2003,72.2,2004,72,1
1031,2007,75,2009,71.6,2
1031,2009,71.6,2011,71.6,2
1031,2011,71.6,2015,71.6,4
1032,2009,63.3,2011,61.9,2
1032,2011,61.9,2013,61.9,2
1032,2015,99.2,2017,94.5,2
1033,2003,48.6,2004,41.5,1
1033,2004,41.5,2006,37,2
1033,2011,99.3,2013,99,2
1033,2013,99,2015,97.8,2
1033,2015,97.8,2017,90,2
1034,1963,100,2011,73.5,48
1034,2011,73.5,2013,70.3,2
1034,2013,70.3,2015,67.2,2
1034,2015,67.2,2017,65.2,2
1035,1964,100,2003,75,39
1035,2003,75,2004,73.2,1
1035,2004,73.2,2006,73.1,2
1035,2007,73.9,2009,73.8,2
1035,2009,73.8,2013,72.9,4
1035,2013,72.9,2015,72.3,2
1035,2015,72.3,2017,72.3,2
1036,1965,100,2003,71.6,38
1036,2003,71.6,2004,71.6,1
1036,2004,71.6,2006,71.2,2
1036,2006,71.2,2007,70,1
1036,2013,72.2,2015,71.4,2
1036,2015,71.4,2017,70.4,2
1037,1960,100,2003,66.5,43
1037,2003,66.5,2004,66,1
1037,2006,67.4,2007,56,1
1037,2011,57.7,2013,54.7,2
1037,2015,54.8,2017,54.4,2
1038,1960,100,2003,74.7,43
1038,2004,75,2006,72.4,2
1038,2007,74.4,2009,63.5,2
1038,2009,63.5,2011,36.2,2
1038,2013,37,2015,34.8,2
1038,2015,34.8,2017,34.8,2
1039,1970,100,2003,46.6,33
1039,2004,50.1,2006,41.8,2
1039,2007,50.7,2009,46.2,2
1039,2011,47.3,2013,47.3,2
1039,2013,47.3,2015,46.4,2
1039,2015,46.4,2017,46.4,2
1040,1940,100,2003,74.7,63
1040,2003,74.7,2004,74.7,1
1040,2004,74.7,2006,70.2,2
1040,2006,70.2,2007,67.9,1
1040,2011,73.8,2015,70.1,4
1041,1956,100,2003,74,47
1041,2003,74,2004,71.2,1
1041,2007,74.1,2009,73.9,2
1041,2011,77.7,2015,73.7,4
1041,2015,73.7,2017,72.9,2
1042,1958,100,2003,72.7,45
1042,2003,72.7,2004,72.4,1
1042,2006,74,2007,71.6,1
1042,2007,71.6,2009,70.8,2
1042,2013,71.9,2015,71.4,2
1042,2015,71.4,2017,71.4,2
1043,1965,100,2003,75,38
1043,2003,75,2004,75,1
1043,2004,75,2006,75,2
1043,2006,75,2007,74.2,1
1043,2013,74.8,2015,74.6,2
1043,2015,74.6,2017,74.6,2
1044,1965,100,2003,75,38
1044,2003,75,2004,74.3,1
1044,2004,74.3,2006,74.1,2
1044,2009,75,2013,68.8,4
1044,2013,68.8,2015,66.6,2
1044,2015,66.6,2017,66.6,2
1045,1942,100,2003,75,61
1045,2003,75,2004,72.9,1
1045,2004,72.9,2006,52.2,2
1045,2007,75,2009,74.1,2
1045,2009,74.1,2013,74.1,4
1045,2013,74.1,2015,60,2
1045,2015,60,2017,60,2
1046,1942,100,2003,60.3,61
1046,2003,60.3,2004,57.1,1
1046,2004,57.1,2006,57.1,2
1046,2007,73.4,2009,72.7,2
1046,2009,72.7,2011,70.4,2
1046,2011,70.4,2013,70.3,2
1046,2013,70.3,2015,69.8,2
1046,2015,69.8,2017,69.8,2
1047,2003,68.2,2004,60,1
1047,2007,99.4,2009,99.4,2
1047,2009,99.4,2011,98.9,2
1047,2011,98.9,2015,98.9,4
1048,1938,100,2003,74.9,65
1048,2003,74.9,2004,74.9,1
1048,2004,74.9,2006,74.8,2
1048,2007,75,2009,73.7,2
1048,2009,73.7,2011,51.1,2
1048,2013,52.2,2015,48.2,2
1048,2015,48.2,2017,47,2
1049,2003,71.8,2004,71.8,1
1049,2004,71.8,2006,65.8,2
1049,2006,65.8,2007,56.6,1
1049,2009,100,2013,98.4,4
1049,2013,98.4,2017,90.7,4
1050,1958,100,2003,75,45
1050,2003,75,2004,75,1
1050,2004,75,2006,73,2
1050,2006,73,2007,71.6,1
1050,2009,74.8,2011,74.5,2
1050,2011,74.5,2015,73.8,4
1050,2015,73.8,2017,73.3,2
1051,1942,100,2003,72.8,61
1051,2003,72.8,2004,72.8,1
1051,2004,72.8,2006,65.9,2
1051,2007,75,2009,69.4,2
1051,2011,70.9,2013,69.9,2
1051,2013,69.9,2015,69.9,2
1051,2015,69.9,2017,69.9,2
1052,1958,100,2003,74.8,45
1052,2003,74.8,2004,40.4,1
1052,2007,75,2009,73.8,2
1052,2009,73.8,2011,73.4,2
1052,2011,73.4,2015,72.8,4
1053,1961,100,2006,34.8,45
1053,2007,75,2009,60.1,2
1053,2009,60.1,2011,57.9,2
1053,2011,57.9,2013,57.9,2
1053,2013,57.9,2015,56.1,2
1053,2015,56.1,2017,56.1,2
1054,1958,100,2006,72.9,48
1054,2007,75,2009,70.3,2
1054,2009,70.3,2011,70.1,2
1054,2013,70.8,2015,69.8,2
1054,2015,69.8,2017,69.7,2
1055,2002,68,2003,60.9,1
1055,2003,60.9,2005,59.3,2
1055,2006,65.5,2008,65.4,2
1055,2008,65.4,2010,65.3,2
1055,2010,65.3,2012,65.3,2
1055,2014,99.1,2016,95.2,2
1056,2003,73.8,2005,69,2
1056,2005,69,2006,68.7,1
1056,2008,70.1,2010,69.8,2
1056,2012,99.4,2014,98.7,2
1056,2014,98.7,2016,95.4,2
1057,1998,100,2002,100,4
1057,2002,100,2003,99.5,1
1057,2003,99.5,2005,75.1,2
1057,2006,97.6,2008,86,2
1057,2008,86,2010,83,2
1057,2012,91.3,2014,90.3,2
1057,2014,90.3,2016,87.9,2
1058,1969,100,2002,74.7,33
1058,2002,74.7,2003,73.1,1
1058,2003,73.1,2005,69.4,2
1058,2006,69.8,2008,69.7,2
1058,2008,69.7,2010,68.6,2
1058,2010,68.6,2012,68.4,2
1058,2012,68.4,2014,68.2,2
1058,2014,68.2,2016,67.5,2
1059,2001,100,2002,99.3,1
1059,2003,99.5,2005,77,2
1059,2010,98.5,2012,97.3,2
1059,2012,97.3,2014,96.4,2
1059,2014,96.4,2016,82.4,2
1060,1981,100,2002,74.2,21
1060,2002,74.2,2003,73.1,1
1060,2006,88.6,2008,74.2,2
1060,2008,74.2,2010,74.2,2
1060,2010,74.2,2012,72.3,2
1060,2012,72.3,2014,71.7,2
1061,2006,100,2007,75,1
1061,2011,87.7,2015,83.9,4
1062,1968,100,2005,74,37
1062,2005,74,2006,70.1,1
1062,2008,70.3,2010,69.5,2
1062,2012,69.7,2014,68.4,2
1063,2006,100,2008,100,2
1063,2008,100,2010,75,2
1064,2005,75,2006,70.7,1
1064,2008,84.6,2010,83.1,2
1064,2010,83.1,2014,83.1,4
1065,2008,100,2010,90.1,2
1066,2003,60.5,2005,59.2,2
1066,2011,73.5,2013,72.3,2
1066,2013,72.3,2017,70.4,4
1067,2003,72.4,2005,72.4,2
1067,2009,73.8,2011,73.8,2
1067,2013,87.2,2017,82.8,4
1068,1972,100,2003,46.3,31
1068,2003,46.3,2005,46.1,2
1068,2009,56.6,2015,56.3,6
1068,2015,56.3,2017,56.3,2
1069,1973,100,2003,69.3,30
1069,2003,69.3,2005,68.9,2
1069,2005,68.9,2007,68.6,2
1069,2013,73.2,2015,73.1,2
1070,1993,100,2003,64.1,10
1070,2003,64.1,2005,60.3,2
1070,2007,62.8,2009,62.3,2
1070,2011,70.1,2013,67,2
1071,1973,100,2003,49.3,30
1071,2003,49.3,2005,49.3,2
1071,2005,49.3,2009,47.4,4
1071,2009,47.4,2013,47.1,4
1071,2013,47.1,2015,45.6,2
1071,2015,45.6,2017,45.6,2
1072,2003,48.7,2005,46.4,2
1072,2009,58.7,2011,56.3,2
1072,2011,56.3,2013,50.5,2
1072,2015,99.9,2017,92.5,2
1073,1978,100,2005,34,27
1073,2005,34,2007,31.8,2
1073,2007,31.8,2009,30.3,2
1073,2009,30.3,2011,30.3,2
1073,2011,30.3,2013,30.3,2
1073,2013,30.3,2015,30.3,2
1073,2015,30.3,2017,30.3,2
1074,1942,100,2003,55.7,61
1074,2004,59.6,2005,52.3,1
1074,2005,52.3,2006,51.2,1
1074,2006,51.2,2007,37.4,1
1074,2009,45.1,2010,43.4,1
1074,2010,43.4,2011,42,1
1074,2012,46.9,2013,41.9,1
1074,2013,41.9,2014,36.7,1
1074,2015,41.3,2017,41.3,2
1075,2001,50.9,2003,50.2,2
1075,2003,50.2,2005,36.7,2
1075,2005,36.7,2007,36.7,2
1075,2007,36.7,2009,35.9,2
1075,2011,99.7,2013,99.2,2
1075,2013,99.2,2015,98.7,2
1075,2015,98.7,2017,80.6,2
1076,1972,100,2003,71.8,31
1076,2005,71.9,2007,71.5,2
1076,2007,71.5,2009,71.3,2
1076,2009,71.3,2011,70.3,2
1076,2013,71.2,2015,71.2,2
1076,2015,71.2,2017,67.6,2
1077,2003,64.7,2005,58.2,2
1077,2007,58.5,2009,53.8,2
1077,2011,99.8,2013,99.1,2
1077,2013,99.1,2015,98.4,2
1077,2015,98.4,2017,88.4,2
1078,1960,100,2001,68.5,41
1078,2001,68.5,2005,56.6,4
1078,2009,64.2,2013,63.9,4
1079,1965,100,2003,70.4,38
1079,2003,70.4,2005,70.4,2
1079,2005,70.4,2007,69.5,2
1079,2007,69.5,2009,68.8,2
1079,2011,70.5,2013,70,2
1079,2015,70.9,2017,70.8,2
1080,1965,100,2003,62.1,38
1080,2003,62.1,2005,62.1,2
1080,2005,62.1,2007,61.2,2
1080,2007,61.2,2009,61.1,2
1080,2015,69.7,2017,69.7,2
1081,1965,100,2003,69.5,38
1081,2005,71.6,2007,68,2
1081,2015,70.2,2017,70.1,2
1082,1975,100,2001,89.8,26
1082,2001,89.8,2005,59.5,4
1082,2009,67.4,2013,64.5,4
1082,2013,64.5,2015,58.2,2
1082,2015,58.2,2017,49.2,2
1083,2003,72.5,2005,70.3,2
1083,2011,96.1,2013,92,2
1083,2013,92,2015,89.5,2
1083,2015,89.5,2017,89,2
1084,1982,100,2003,73.2,21
1084,2003,73.2,2005,72.1,2
1084,2005,72.1,2007,71.6,2
1084,2007,71.6,2009,71.5,2
1084,2011,71.8,2013,71.8,2
1084,2013,71.8,2015,71.5,2
1084,2015,71.5,2017,71.2,2
1085,1984,100,2001,70.4,17
1085,2003,73.1,2005,71.4,2
1085,2005,71.4,2007,71.1,2
1085,2007,71.1,2009,70.8,2
1085,2013,74.4,2015,74.4,2
1085,2015,74.4,2017,73.5,2
1086,1986,100,2003,74.8,17
1086,2003,74.8,2005,72.6,2
1086,2005,72.6,2007,72.2,2
1086,2007,72.2,2009,72,2
1086,2015,74.1,2017,73.7,2
1087,1987,100,2003,74.8,16
1087,2003,74.8,2005,73.5,2
1087,2005,73.5,2007,72.3,2
1087,2011,73,2013,72,2
1087,2013,72,2015,72,2
1088,1958,100,2001,62.5,43
1088,2001,62.5,2005,50.3,4
1088,2013,58.2,2015,57,2
1088,2015,57,2017,55.7,2
1089,1899,100,2001,50.9,102
1089,2001,50.9,2005,49.9,4
1089,2005,49.9,2009,48.6,4
1089,2009,48.6,2013,45.9,4
1089,2013,45.9,2015,41.5,2
1089,2015,41.5,2017,41.4,2
1090,1899,100,2001,61.5,102
1090,2001,61.5,2005,53.9,4
1090,2009,74.3,2013,72,4
1090,2013,72,2017,72,4
1091,1899,100,2001,60.8,102
1091,2001,60.8,2005,48.2,4
1091,2005,48.2,2009,46.7,4
1091,2009,46.7,2013,46.5,4
1092,1899,100,2001,59.3,102
1092,2001,59.3,2005,50.4,4
1092,2005,50.4,2009,50.4,4
1092,2009,50.4,2013,49,4
1092,2013,49,2015,47.4,2
1092,2015,47.4,2017,47.4,2
1093,1899,100,2001,64.8,102
1093,2001,64.8,2005,58.9,4
1093,2009,65.9,2013,64.6,4
1093,2013,64.6,2015,61.7,2
1094,1899,100,2002,61.8,103
1094,2002,61.8,2005,53,3
1094,2005,53,2009,49,4
1094,2013,50.6,2015,49.7,2
1094,2015,49.7,2017,48.2,2
1095,1899,100,2001,63.2,102
1095,2001,63.2,2005,57.3,4
1095,2009,66.8,2013,64.5,4
1096,1944,100,2001,61,57
1096,2001,61,2005,50,4
1096,2009,67.7,2013,67.7,4
1096,2013,67.7,2015,60.5,2
1097,2001,44.2,2005,28,4
1098,1899,100,2001,62.3,102
1098,2001,62.3,2005,57.2,4
1098,2009,71,2013,67.7,4
1098,2013,67.7,2015,66.8,2
1098,2015,66.8,2017,66.8,2
1099,2001,100,2005,68.6,4
1099,2005,68.6,2009,59.1,4
1099,2013,65.4,2015,62.6,2
1099,2015,62.6,2017,62.6,2
1100,1993,100,2005,70.5,12
1100,2005,70.5,2007,66.6,2
1100,2013,70,2015,69.8,2
1101,2003,73.8,2005,71.2,2
1101,2011,95.8,2013,87.8,2
1101,2013,87.8,2015,84.8,2
1101,2015,84.8,2017,82.6,2
1102,1999,100,2003,70,4
1102,2003,70,2005,68.2,2
1102,2005,68.2,2007,68.2,2
1102,2011,72,2013,67.6,2
1103,2003,47.3,2005,39.1,2
1103,2009,48,2013,24.1,4
1103,2013,24.1,2015,16.9,2
1104,1899,100,2005,54.2,106
1104,2005,54.2,2009,48.2,4
1104,2015,51.7,2017,51.6,2
1105,1986,100,2005,59.4,19
1105,2009,66.7,2013,66.1,4
1105,2013,66.1,2015,64.3,2
1106,2013,85.3,2017,81.6,4
1107,2009,39.3,2013,32.9,4
1107,2015,98.1,2017,98.1,2
1108,1899,100,2005,25.2,106
1108,2007,28.7,2009,28.7,2
1108,2011,29.5,2013,28.9,2
1108,2013,28.9,2015,28.7,2
1108,2015,28.7,2017,28.7,2
1109,1899,100,2005,47.7,106
1109,2009,66.2,2013,52.5,4
1109,2013,52.5,2015,52.5,2
1109,2015,52.5,2017,50.9,2
1110,1970,100,2002,88.3,32
1110,2002,88.3,2003,73.4,1
1110,2003,73.4,2005,71.3,2
1110,2005,71.3,2006,71.3,1
1110,2006,71.3,2008,71.1,2
1110,2008,71.1,2010,71.1,2
1110,2010,71.1,2012,69.6,2
1110,2012,69.6,2014,69.4,2
1111,2000,100,2002,100,2
1111,2002,100,2003,94.4,1
1111,2003,94.4,2005,76.3,2
1111,2006,95.8,2008,93.4,2
1111,2010,94.8,2012,94.2,2
1111,2012,94.2,2014,92.2,2
1111,2014,92.2,2016,80.8,2
1112,2000,100,2002,100,2
1112,2002,100,2003,99.5,1
1112,2003,99.5,2005,74,2
1112,2006,92.5,2008,90.3,2
1112,2010,97.3,2012,95.6,2
1112,2012,95.6,2014,94.5,2
1112,2014,94.5,2016,81.6,2
1113,2001,100,2003,99.6,2
1113,2003,99.6,2005,95.8,2
1113,2006,99.1,2008,91.6,2
1113,2010,95.3,2012,95.3,2
1113,2012,95.3,2014,92.6,2
1113,2014,92.6,2016,81,2
1114,1982,100,2002,76.9,20
1114,2002,76.9,2003,71.3,1
1114,2003,71.3,2005,69.5,2
1114,2007,74.6,2008,73,1
1114,2008,73,2010,72.6,2
1114,2010,72.6,2012,72.6,2
1114,2012,72.6,2014,71.4,2
1114,2014,71.4,2016,71.4,2
1115,2003,59.2,2005,48.1,2
1115,2010,99.1,2012,98.5,2
1115,2012,98.5,2014,97.9,2
1115,2014,97.9,2016,92,2
1116,1962,100,2005,66.6,43
1116,2008,71,2010,70.8,2
1116,2010,70.8,2014,70.3,4
1116,2014,70.3,2016,70,2
1117,2002,64.4,2003,64,1
1117,2003,64,2005,58.4,2
1117,2005,58.4,2006,58.4,1
1117,2010,99,2012,98.1,2
1117,2012,98.1,2014,98.1,2
1117,2014,98.1,2016,88.6,2
1118,2007,100,2010,98.2,3
1118,2010,98.2,2012,97.9,2
1118,2012,97.9,2014,97.9,2
1118,2014,97.9,2016,88.4,2
1119,1978,100,2005,74.4,27
1119,2005,74.4,2006,71.7,1
1119,2008,72.5,2010,72,2
1119,2010,72,2014,70.8,4
1120,1956,100,2005,74,49
1120,2005,74,2006,70.5,1
1120,2006,70.5,2008,70.5,2
1120,2008,70.5,2010,68.7,2
1120,2012,70.8,2014,70.5,2
1121,1963,100,2005,68.7,42
1121,2005,68.7,2006,65.3,1
1121,2008,67.3,2010,66.4,2
1122,1963,100,2005,72.1,42
1122,2005,72.1,2006,65.4,1
1122,2008,70.1,2010,68.8,2
1122,2012,70.7,2014,70.5,2
1123,1957,100,2002,74.5,45
1123,2002,74.5,2003,74,1
1123,2003,74,2005,73.2,2
1123,2005,73.2,2006,73,1
1123,2008,74,2010,73.7,2
1123,2010,73.7,2012,72.8,2
1124,1997,100,2002,90.9,5
1124,2003,93.8,2005,74.8,2
1124,2006,95.6,2008,89.4,2
1124,2010,92,2012,87,2
1124,2012,87,2014,84.8,2
1124,2014,84.8,2016,77,2
1125,2002,54.6,2003,54,1
1125,2003,54,2005,51,2
1125,2008,100,2010,99.6,2
1125,2010,99.6,2012,97.4,2
1125,2012,97.4,2014,95.3,2
1125,2014,95.3,2016,87.5,2
1126,2007,100,2010,99,3
1126,2010,99,2012,98.5,2
1126,2012,98.5,2014,98.5,2
1126,2014,98.5,2016,89.1,2
1127,1973,100,2002,89.7,29
1127,2002,89.7,2003,74.5,1
1127,2003,74.5,2005,74.5,2
1127,2006,74.7,2008,74.6,2
1127,2008,74.6,2010,73.3,2
1127,2010,73.3,2012,73.3,2
1127,2012,73.3,2014,73.1,2
1127,2014,73.1,2016,73.1,2
1128,1992,100,2002,96.3,10
1128,2003,96.8,2005,74.5,2
1128,2006,97.3,2008,87.8,2
1128,2008,87.8,2010,87.6,2
1128,2012,89.8,2014,84.9,2
1128,2014,84.9,2016,75.4,2
1129,1991,100,2002,97,11
1129,2002,97,2003,96.8,1
1129,2003,96.8,2005,74.4,2
1129,2008,92.6,2010,92.4,2
1129,2010,92.4,2012,88.5,2
1129,2012,88.5,2014,83.6,2
1129,2014,83.6,2016,75.3,2
1130,1967,100,2005,38.6,38
1130,2005,38.6,2006,22.8,1
1130,2006,22.8,2008,21.1,2
1130,2008,21.1,2010,20.1,2
1130,2014,44.2,2016,39.3,2
1131,1966,100,2002,84.3,36
1131,2002,84.3,2003,70,1
1131,2003,70,2005,66.1,2
1131,2008,75,2010,74.1,2
1131,2010,74.1,2012,74.1,2
1131,2014,76.6,2016,76.1,2
1132,1955,100,2003,55.4,48
1132,2003,55.4,2005,45.1,2
1132,2006,56.4,2008,54.8,2
1132,2010,55.2,2012,53.5,2
1132,2012,53.5,2014,52.5,2
1132,2014,52.5,2016,50.7,2
1133,1969,100,2002,74.5,33
1133,2002,74.5,2003,71.2,1
1133,2003,71.2,2005,68.9,2
1133,2005,68.9,2006,67.9,1
1133,2006,67.9,2008,67.5,2
1133,2008,67.5,2010,65.2,2
1133,2010,65.2,2012,64.7,2
1133,2014,69.6,2016,69.6,2
1134,1999,100,2002,100,3
1134,2002,100,2003,99.8,1
1134,2003,99.8,2005,74.8,2
1134,2006,97.5,2008,97.2,2
1134,2008,97.2,2010,97.1,2
1134,2010,97.1,2012,95.5,2
1134,2012,95.5,2014,93.1,2
1134,2014,93.1,2016,88.9,2
1135,1975,100,2002,71.2,27
1135,2002,71.2,2003,70.7,1
1135,2003,70.7,2005,65.3,2
1135,2005,65.3,2006,62,1
1135,2008,66.2,2010,65.9,2
1135,2010,65.9,2012,65.2,2
1135,2012,65.2,2014,64.4,2
1135,2014,64.4,2016,64.4,2
1136,1979,100,2002,74.2,23
1136,2003,75.2,2005,73.9,2
1136,2006,74.7,2008,74.4,2
1136,2008,74.4,2010,73.9,2
1136,2010,73.9,2012,73.6,2
1136,2012,73.6,2014,70.2,2
1136,2014,70.2,2016,70.2,2
1137,1985,100,2002,86.6,17
1137,2002,86.6,2003,72.9,1
1137,2003,72.9,2005,71.9,2
1137,2006,90.6,2008,84.6,2
1137,2008,84.6,2010,83.5,2
1137,2010,83.5,2012,82.5,2
1137,2012,82.5,2014,77.9,2
1137,2014,77.9,2016,74.7,2
1138,1985,100,2002,91.9,17
1138,2002,91.9,2003,74.1,1
1138,2003,74.1,2005,71.2,2
1138,2008,92,2010,88.8,2
1138,2010,88.8,2012,85,2
1138,2012,85,2014,80.1,2
1138,2014,80.1,2016,74.9,2
1139,1984,100,2002,94.4,18
1139,2002,94.4,2003,73.4,1
1139,2003,73.4,2005,72.5,2
1139,2006,90.4,2008,90,2
1139,2008,90,2010,86.8,2
1139,2010,86.8,2012,81.1,2
1139,2012,81.1,2014,76.5,2
1139,2014,76.5,2016,74.4,2
1140,1987,100,2002,94.6,15
1140,2002,94.6,2003,94.6,1
1140,2003,94.6,2005,75.1,2
1140,2006,75.5,2008,74.7,2
1140,2008,74.7,2010,74.7,2
1140,2010,74.7,2012,74.3,2
1140,2012,74.3,2014,74,2
1140,2014,74,2016,74,2
1141,1976,100,2005,71.5,29
1141,2006,74.7,2008,74.7,2
1141,2008,74.7,2010,74,2
1141,2010,74,2014,73.9,4
1142,1977,100,2005,74.4,28
1142,2005,74.4,2006,72.8,1
1142,2006,72.8,2008,72.8,2
1142,2008,72.8,2010,72.4,2
1142,2010,72.4,2014,71.8,4
1143,1988,100,2002,97.2,14
1143,2002,97.2,2003,97,1
1143,2003,97,2005,75.3,2
1143,2006,92.9,2008,75,2
1143,2012,76.3,2014,74,2
1143,2014,74,2016,72.6,2
1144,1989,100,2002,94.1,13
1144,2003,96.3,2005,75.8,2
1144,2010,85.5,2012,81.4,2
1144,2012,81.4,2014,74.8,2
1144,2014,74.8,2016,74.7,2
1145,1997,100,2002,98,5
1145,2003,98.3,2005,74.5,2
1145,2006,95.1,2008,94.8,2
1145,2008,94.8,2010,90,2
1145,2010,90,2012,86.2,2
1145,2012,86.2,2014,86.1,2
1145,2014,86.1,2016,78.7,2
1146,2000,100,2002,98.4,2
1146,2002,98.4,2003,98.1,1
1146,2003,98.1,2005,81.4,2
1146,2006,97.9,2008,97.2,2
1146,2008,97.2,2010,97.2,2
1146,2010,97.2,2012,95.2,2
1146,2012,95.2,2014,91.7,2
1146,2014,91.7,2016,80.6,2
1147,2000,100,2002,99.1,2
1147,2002,99.1,2003,98.4,1
1147,2003,98.4,2005,84.7,2
1147,2006,98.1,2008,98.1,2
1147,2008,98.1,2010,98,2
1147,2010,98,2012,94.9,2
1147,2012,94.9,2014,93.8,2
1147,2014,93.8,2016,80.9,2
1148,1960,100,2005,69.3,45
1148,2005,69.3,2006,57.7,1
1148,2006,57.7,2008,50.9,2
1148,2008,50.9,2010,48.2,2
1148,2012,64.8,2014,55.9,2
1148,2014,55.9,2016,55.6,2
1149,2001,100,2005,73.9,4
1149,2006,100,2008,75,2
1150,2001,100,2006,99.8,5
1150,2006,99.8,2008,96.5,2
1151,1966,100,2005,56.2,39
1151,2006,72.3,2008,68.6,2
1151,2008,68.6,2010,68,2
1151,2012,70.3,2014,69.3,2
1151,2014,69.3,2016,69.3,2
1152,1999,100,2005,73.1,6
1152,2007,94.3,2008,82.4,1
1152,2008,82.4,2010,80.9,2
1152,2014,83,2016,78.8,2
1153,2005,100,2006,100,1
1153,2006,100,2008,99.8,2
1153,2008,99.8,2010,98.8,2
1153,2010,98.8,2014,98.3,4
1154,1970,100,2005,56.9,35
1154,2005,56.9,2006,38.6,1
1154,2008,56.3,2010,55.9,2
1154,2010,55.9,2012,54.6,2
1154,2012,54.6,2014,54.3,2
1155,2005,72.1,2006,40,1
1155,2008,98.8,2010,94.6,2
1156,2001,100,2005,69.8,4
1156,2006,99.3,2008,96.8,2
1156,2008,96.8,2010,94.7,2
1157,2001,100,2005,72.9,4
1157,2006,97.6,2008,97.5,2
1158,2001,100,2005,74.9,4
1158,2006,81.1,2008,78.9,2
1159,2001,100,2005,74.8,4
1159,2006,98.4,2008,92.2,2
1160,1993,100,2002,98.6,9
1160,2002,98.6,2003,98.3,1
1160,2003,98.3,2005,74.7,2
1160,2008,98.6,2010,95.5,2
1160,2010,95.5,2012,82,2
1160,2012,82,2014,80.4,2
1160,2014,80.4,2016,75.2,2
1161,1993,100,2002,98.2,9
1161,2003,98.7,2005,74.5,2
1161,2006,92,2008,84.9,2
1161,2008,84.9,2010,82.7,2
1161,2010,82.7,2012,81.8,2
1161,2012,81.8,2014,80.3,2
1161,2014,80.3,2016,74.6,2
1162,1996,100,2002,98.6,6
1162,2002,98.6,2003,95.8,1
1162,2003,95.8,2005,74.9,2
1162,2006,96.3,2008,95.7,2
1162,2008,95.7,2010,91.6,2
1162,2010,91.6,2012,87.1,2
1162,2014,87.6,2016,77,2
1163,1996,100,2002,98.3,6
1163,2002,98.3,2003,97.6,1
1163,2003,97.6,2005,75.2,2
1163,2006,96.3,2008,76.6,2
1163,2014,82.9,2016,77.7,2
1164,1996,100,2002,99,6
1164,2002,99,2003,96.9,1
1164,2003,96.9,2005,74,2
1164,2006,97,2008,90.1,2
1164,2008,90.1,2010,90.1,2
1164,2010,90.1,2012,89.2,2
1164,2014,89.5,2016,77.6,2
1165,1996,100,2002,98.4,6
1165,2002,98.4,2003,97.2,1
1165,2003,97.2,2005,74.5,2
1165,2006,96.8,2008,96.6,2
1165,2008,96.6,2010,95.7,2
1165,2010,95.7,2012,90.9,2
1165,2012,90.9,2014,88.9,2
1165,2014,88.9,2016,76.7,2
1166,1997,100,2002,98.2,5
1166,2002,98.2,2003,95.6,1
1166,2003,95.6,2005,74.7,2
1166,2006,97.4,2008,92.6,2
1166,2008,92.6,2010,91.5,2
1166,2010,91.5,2012,87,2
1166,2012,87,2014,85.4,2
1166,2014,85.4,2016,77.4,2
1167,1957,100,2005,42.1,48
1167,2008,49,2010,48.1,2
1167,2010,48.1,2012,48.1,2
1167,2014,63.2,2016,62.5,2
1168,1995,100,2002,99.1,7
1168,2002,99.1,2003,97.8,1
1168,2003,97.8,2005,74.1,2
1168,2006,98.1,2008,86.7,2
1168,2008,86.7,2010,85.3,2
1168,2010,85.3,2012,81.4,2
1168,2012,81.4,2014,80.1,2
1168,2014,80.1,2016,75.5,2
1169,1995,100,2002,99.1,7
1169,2002,99.1,2003,97.7,1
1169,2003,97.7,2005,79.8,2
1169,2006,95.2,2008,88.1,2
1169,2008,88.1,2010,84.1,2
1169,2010,84.1,2012,79.7,2
1169,2014,79.8,2016,75.2,2
1170,1995,100,2002,97.9,7
1170,2003,99,2005,74.9,2
1170,2008,97.7,2010,96.1,2
1170,2010,96.1,2012,91.7,2
1170,2012,91.7,2014,89.6,2
1170,2014,89.6,2016,77.3,2
1171,1997,100,2002,98.1,5
1171,2002,98.1,2003,97.2,1
1171,2003,97.2,2005,74.5,2
1171,2006,98.2,2008,85.7,2
1171,2008,85.7,2010,83.5,2
1171,2010,83.5,2012,80.3,2
1171,2012,80.3,2014,80,2
1171,2014,80,2016,75.3,2
1172,1997,100,2002,97.8,5
1172,2003,98.5,2005,84.4,2
1172,2006,94,2008,88.4,2
1172,2008,88.4,2010,86.1,2
1172,2010,86.1,2012,83.4,2
1172,2012,83.4,2014,81.9,2
1172,2014,81.9,2016,75.1,2
1173,1997,100,2002,99.5,5
1173,2002,99.5,2003,98.7,1
1173,2003,98.7,2005,78.9,2
1173,2006,97.5,2008,95.7,2
1173,2008,95.7,2010,93,2
1173,2010,93,2012,89.6,2
1173,2012,89.6,2014,89.4,2
1173,2014,89.4,2016,78.9,2
1174,1994,100,2005,74.5,11
1174,2010,91.3,2014,88.1,4
1174,2014,88.1,2016,75,2
1175,1994,100,2005,74.7,11
1175,2006,95,2008,93.4,2
1175,2008,93.4,2010,88,2
1175,2010,88,2016,74.1,6
1176,1994,100,2005,74.8,11
1176,2006,95,2008,92.8,2
1176,2008,92.8,2010,92.8,2
1177,1994,100,2005,74.7,11
1177,2006,96.3,2008,94.1,2
1177,2008,94.1,2010,93.3,2
1178,2006,100,2007,100,1
1178,2007,100,2008,98,1
1178,2010,99.2,2012,98.6,2
1178,2012,98.6,2014,98.5,2
1178,2014,98.5,2016,87.8,2
1179,2005,100,2007,100,2
1179,2007,100,2008,99,1
1179,2008,99,2010,98.8,2
1179,2010,98.8,2012,98.1,2
1179,2012,98.1,2014,98,2
1179,2014,98,2016,86.5,2
1180,2000,100,2002,100,2
1180,2002,100,2003,99.7,1
1180,2003,99.7,2006,92.5,3
1180,2006,92.5,2008,89.5,2
1180,2010,95.6,2012,95.3,2
1180,2012,95.3,2014,93.6,2
1180,2014,93.6,2016,81.2,2
1181,1999,100,2002,98.6,3
1181,2002,98.6,2003,98,1
1181,2003,98,2005,97.9,2
1181,2005,97.9,2006,96.1,1
1181,2006,96.1,2008,95.8,2
1181,2008,95.8,2010,95.7,2
1181,2010,95.7,2012,93.6,2
1181,2012,93.6,2014,91.2,2
1181,2014,91.2,2016,79.9,2
1182,2007,100,2010,96.9,3
1182,2012,98.1,2014,98.1,2
1182,2014,98.1,2016,88.6,2
1183,2007,100,2010,98.7,3
1183,2010,98.7,2012,98.3,2
1183,2012,98.3,2014,98,2
1183,2014,98,2016,87,2
1184,2007,100,2010,99.1,3
1184,2010,99.1,2012,98.5,2
1184,2012,98.5,2014,98.3,2
1184,2014,98.3,2016,88.3,2
1185,2001,100,2003,98.6,2
1185,2003,98.6,2005,74.9,2
1185,2006,99.8,2008,91.5,2
1185,2010,98.7,2012,96.4,2
1185,2012,96.4,2014,95.1,2
1185,2014,95.1,2016,82.1,2
1186,2002,100,2003,99.5,1
1186,2003,99.5,2005,74.5,2
1186,2006,98.5,2008,97,2
1186,2010,99,2012,96.6,2
1186,2012,96.6,2014,95.4,2
1186,2014,95.4,2016,81.7,2
1187,2001,100,2003,99.6,2
1187,2003,99.6,2005,97,2
1187,2005,97,2006,94.1,1
1187,2006,94.1,2008,87.3,2
1187,2012,94.4,2014,93.2,2
1187,2014,93.2,2016,81,2
1188,2001,100,2003,98.5,2
1188,2003,98.5,2005,82,2
1188,2006,98.9,2008,89.1,2
1188,2012,92.1,2014,89.1,2
1188,2014,89.1,2016,78,2
1189,2001,100,2003,99.3,2
1189,2003,99.3,2005,78.4,2
1189,2006,97.5,2008,89,2
1189,2012,93.1,2014,89.8,2
1189,2014,89.8,2016,79.1,2
1190,2001,100,2003,99.8,2
1190,2003,99.8,2005,74.7,2
1190,2006,89.3,2008,89.3,2
1190,2010,96.5,2012,95.6,2
1190,2012,95.6,2014,93.9,2
1190,2014,93.9,2016,80.3,2
1191,1956,100,2012,72.4,56
1191,2012,72.4,2014,72,2
1191,2014,72,2016,72,2
1192,1938,100,2001,52.9,63
1192,2001,52.9,2003,49.7,2
1192,2003,49.7,2005,49.7,2
1192,2005,49.7,2007,46.4,2
1192,2013,79.8,2015,75.8,2
1192,2015,75.8,2017,72.4,2
1193,2001,100,2003,100,2
1193,2003,100,2005,99.6,2
1193,2005,99.6,2007,98.5,2
1193,2007,98.5,2009,98.1,2
1193,2009,98.1,2011,97.3,2
1193,2011,97.3,2013,94.8,2
1193,2013,94.8,2015,92.7,2
1193,2015,92.7,2017,80.3,2
1194,1987,100,2001,74.3,14
1194,2003,74.9,2005,74.7,2
1194,2005,74.7,2007,74.4,2
1194,2007,74.4,2008,74.4,1
1194,2008,74.4,2010,74.2,2
1194,2010,74.2,2012,74.1,2
1194,2012,74.1,2014,74.1,2
1194,2014,74.1,2016,74.1,2
1195,1981,100,2001,76.6,20
1195,2001,76.6,2003,70,2
1195,2005,72.9,2007,72.2,2
1195,2008,73.2,2010,72.8,2
1195,2010,72.8,2012,72.3,2
1195,2012,72.3,2014,71.3,2
1195,2014,71.3,2016,71.3,2
1196,2003,71.7,2005,63.5,2
1196,2007,69,2008,68.8,1
1196,2012,99,2014,96.3,2
1196,2014,96.3,2016,91.1,2
1197,2003,53.9,2005,46.6,2
1197,2005,46.6,2007,46.6,2
1197,2007,46.6,2008,46.6,1
1197,2010,98.1,2012,97.2,2
1197,2012,97.2,2014,96.4,2
1197,2014,96.4,2016,88.8,2
1198,1949,100,2003,74.5,54
1198,2003,74.5,2005,74,2
1198,2005,74,2007,73.3,2
1198,2007,73.3,2008,70.5,1
1198,2010,75.6,2014,73.8,4
1198,2014,73.8,2016,73.4,2
1199,1949,100,2003,71.4,54
1199,2003,71.4,2005,69.6,2
1199,2005,69.6,2007,60.3,2
1199,2008,66,2010,66,2
1199,2012,73.4,2014,70.8,2
1199,2014,70.8,2016,70,2
1200,1949,100,2003,72.2,54
1200,2005,72.3,2007,63.5,2
1200,2007,63.5,2008,62.6,1
1200,2012,74.7,2014,73.3,2
1200,2014,73.3,2016,72.6,2
1201,1948,100,2003,74.1,55
1201,2003,74.1,2005,71,2
1201,2008,79.3,2010,75.6,2
1201,2010,75.6,2014,72.6,4
1201,2014,72.6,2016,72,2
1202,2005,98.6,2007,97.6,2
1202,2007,97.6,2008,96.7,1
1202,2008,96.7,2010,93.4,2
1202,2010,93.4,2012,92.6,2
1202,2012,92.6,2014,91.9,2
1202,2014,91.9,2016,83.4,2
1203,1982,100,2001,73.8,19
1203,2003,87.4,2005,85.1,2
1203,2005,85.1,2007,74.9,2
1203,2007,74.9,2008,74.6,1
1203,2008,74.6,2010,74,2
1203,2012,74.4,2014,73.7,2
1203,2014,73.7,2016,73.6,2
1204,1938,100,2001,53,63
1204,2003,63.9,2005,57,2
1204,2007,73.5,2008,73.2,1
1204,2008,73.2,2010,71.9,2
1204,2012,72.6,2014,70,2
1204,2014,70,2016,68.1,2
1205,1937,100,2001,61.7,64
1205,2001,61.7,2003,61.3,2
1205,2003,61.3,2005,58.4,2
1205,2008,68.8,2010,68.4,2
1205,2010,68.4,2012,67.5,2
1205,2012,67.5,2014,67,2
1205,2014,67,2016,67,2
1206,1953,100,2003,72.5,50
1206,2007,73.9,2008,73.8,1
1206,2008,73.8,2010,72.7,2
1206,2010,72.7,2014,72.6,4
1206,2014,72.6,2016,72.5,2
1207,1959,100,2003,74.8,44
1207,2003,74.8,2005,74.2,2
1207,2005,74.2,2007,72.6,2
1207,2007,72.6,2008,71.8,1
1207,2008,71.8,2010,71.3,2
1207,2014,72.6,2016,72.6,2
1208,2003,67.3,2005,65.3,2
1208,2005,65.3,2007,9.9,2
1208,2008,98.2,2010,97.4,2
1208,2010,97.4,2014,95.5,4
1209,1949,100,2003,74.2,54
1209,2003,74.2,2005,68.7,2
1209,2007,70.2,2008,70.2,1
1209,2008,70.2,2010,69.8,2
1209,2010,69.8,2012,65.7,2
1209,2014,74.4,2016,71.5,2
1210,1932,100,2003,63.8,71
1210,2003,63.8,2005,59.9,2
1210,2007,60.5,2008,60.5,1
1210,2008,60.5,2010,60.4,2
1210,2010,60.4,2012,56.4,2
1210,2012,56.4,2014,54.8,2
1210,2014,54.8,2016,54.6,2
1211,1960,100,2003,74.9,43
1211,2003,74.9,2005,73,2
1211,2005,73,2007,67.2,2
1211,2007,67.2,2008,67.2,1
1211,2008,67.2,2010,64.4,2
1211,2012,70.2,2014,67.8,2
1211,2014,67.8,2016,67.2,2
1212,2000,61.2,2002,47.1,2
1212,2002,47.1,2004,46,2
1212,2004,46,2006,45,2
1212,2010,99,2012,97.4,2
1212,2012,97.4,2014,96.4,2
1212,2014,96.4,2016,88.1,2
1213,2000,100,2002,100,2
1213,2002,100,2003,99.9,1
1213,2003,99.9,2005,77.9,2
1213,2006,98,2008,96.6,2
1213,2010,97.5,2012,96.8,2
1213,2012,96.8,2014,94.6,2
1213,2014,94.6,2016,81.4,2
1214,2000,55.3,2002,52.8,2
1214,2002,52.8,2004,52.6,2
1214,2004,52.6,2006,51.6,2
1214,2010,96.3,2012,95.9,2
1214,2012,95.9,2014,95,2
1214,2014,95,2016,87.8,2
1215,1938,100,2006,72.1,68
1215,2006,72.1,2008,72.1,2
1215,2010,74.6,2014,72.5,4
1215,2014,72.5,2016,69.6,2
1216,1986,100,2002,98.8,16
1216,2002,98.8,2004,75,2
1216,2004,75,2006,74.6,2
1216,2006,74.6,2008,74.4,2
1216,2008,74.4,2010,74,2
1216,2010,74,2012,74,2
1216,2012,74,2014,73.8,2
1216,2014,73.8,2016,72.2,2
1217,1948,100,2003,73.6,55
1217,2003,73.6,2005,73.4,2
1217,2005,73.4,2007,70.4,2
1217,2010,71.7,2014,71.1,4
1218,1937,100,2001,57.5,64
1218,2005,62.6,2007,59.2,2
1218,2007,59.2,2008,57.8,1
1218,2008,57.8,2010,57.5,2
1218,2010,57.5,2012,55.4,2
1218,2012,55.4,2014,54.8,2
1218,2014,54.8,2016,53.1,2
1219,1973,100,2001,68.6,28
1219,2003,72.8,2005,63.7,2
1219,2007,72,2008,71.9,1
1219,2010,77.4,2012,76.6,2
1219,2012,76.6,2014,76.5,2
1219,2014,76.5,2016,74.8,2
1220,1981,100,2001,75.1,20
1220,2003,75.3,2005,74.7,2
1220,2005,74.7,2007,74.7,2
1220,2007,74.7,2008,74.7,1
1220,2008,74.7,2010,74.4,2
1220,2012,74.9,2014,74.4,2
1220,2014,74.4,2016,73.9,2
1221,1984,100,2001,73.8,17
1221,2003,74.1,2005,74,2
1221,2007,82.7,2008,75,1
1221,2008,75,2010,74.7,2
1221,2010,74.7,2012,74,2
1221,2012,74,2014,74,2
1221,2014,74,2016,73.6,2
1222,1938,100,2003,74.8,65
1222,2003,74.8,2005,74.2,2
1222,2007,74.6,2008,74.3,1
1222,2008,74.3,2010,73.8,2
1222,2010,73.8,2014,73.5,4
1223,1948,100,2003,73.4,55
1223,2005,73.6,2007,70.2,2
1223,2008,72.4,2010,71.7,2
1223,2010,71.7,2014,71,4
1224,1940,100,2000,74.9,60
1224,2000,74.9,2004,72.2,4
1224,2004,72.2,2006,66.2,2
1224,2006,66.2,2008,64.7,2
1224,2012,72.6,2014,71.4,2
1225,2008,63.8,2010,56.2,2
1225,2012,56.7,2014,56.4,2
1225,2014,56.4,2016,56.4,2
1226,1939,100,2003,74,64
1226,2003,74,2005,73.9,2
1226,2007,74.2,2008,74.2,1
1226,2008,74.2,2010,71.4,2
1226,2014,72.8,2016,72.8,2
1227,1938,100,2003,72.1,65
1227,2003,72.1,2005,65.7,2
1227,2005,65.7,2007,65.6,2
1227,2007,65.6,2009,65.6,2
1227,2009,65.6,2011,63.7,2
1227,2011,63.7,2013,60.9,2
1227,2013,60.9,2015,59.8,2
1228,1938,100,2003,73.3,65
1228,2003,73.3,2005,67,2
1228,2005,67,2007,65.7,2
1228,2007,65.7,2009,65.7,2
1228,2009,65.7,2011,64.1,2
1228,2013,65.6,2015,64.5,2
1229,1982,100,2003,70.7,21
1229,2005,72.6,2007,72.4,2
1229,2007,72.4,2008,58.3,1
1229,2010,73.8,2014,71.9,4
1229,2014,71.9,2016,70.1,2
1230,1969,100,2003,68,34
1230,2005,70,2007,54.2,2
1230,2010,75.3,2014,74.2,4
1230,2014,74.2,2016,74.2,2
1231,2007,100,2008,98.3,1
1231,2008,98.3,2010,88.1,2
1232,1960,100,2003,71,43
1232,2003,71,2005,67.6,2
1232,2005,67.6,2007,59.8,2
1232,2007,59.8,2008,59.8,1
1232,2012,68.7,2014,67.1,2
1232,2014,67.1,2016,66.9,2
1233,2008,100,2010,98.7,2
1234,1964,100,2003,72.6,39
1234,2008,86.9,2010,86.1,2
1234,2010,86.1,2014,85.1,4
1235,1948,100,2003,69.6,55
1235,2005,71.5,2007,68.7,2
1235,2007,68.7,2008,67.5,1
1235,2008,67.5,2010,66.7,2
1235,2012,69.3,2014,69.3,2
1235,2014,69.3,2016,69.3,2
1236,2003,68.9,2005,67.1,2
1236,2005,67.1,2007,66.3,2
1236,2007,66.3,2008,66.3,1
1236,2008,66.3,2010,66.3,2
1236,2010,66.3,2012,66.2,2
1236,2012,66.2,2014,66.2,2
1237,1986,100,2003,99.7,17
1237,2003,99.7,2007,72.9,4
1237,2007,72.9,2008,71.9,1
1237,2008,71.9,2010,70.3,2
1237,2010,70.3,2014,70.1,4
1237,2014,70.1,2016,68.4,2
1238,2001,100,2003,99.9,2
1238,2003,99.9,2005,74,2
1239,1959,100,2003,73.6,44
1239,2003,73.6,2005,71.4,2
1239,2007,74.1,2008,73.8,1
1239,2008,73.8,2010,71.7,2
1239,2010,71.7,2014,71.5,4
1239,2014,71.5,2016,70.8,2
1240,1978,100,2003,75,25
1240,2003,75,2005,72.4,2
1240,2005,72.4,2007,66.5,2
1240,2008,68.1,2010,67.5,2
1240,2010,67.5,2012,65.8,2
1240,2012,65.8,2014,64.3,2
1240,2014,64.3,2016,63.5,2
1241,1962,100,2004,98.9,42
1241,2004,98.9,2005,73.1,1
1241,2005,73.1,2007,71.6,2
1241,2007,71.6,2008,71.5,1
1241,2008,71.5,2010,69.5,2
1241,2012,72.2,2014,71.3,2
1241,2014,71.3,2016,69.3,2
1242,2005,81.9,2007,75,2
1242,2007,75,2008,74.2,1
1243,1963,100,2005,83,42
1243,2005,83,2007,65.2,2
1243,2007,65.2,2008,63.6,1
1243,2008,63.6,2010,63.1,2
1243,2010,63.1,2012,63.1,2
1243,2014,75.3,2016,73.5,2
1244,2003,65.4,2005,64.9,2
1244,2005,64.9,2007,56.1,2
1244,2007,56.1,2008,51.5,1
1244,2010,97.6,2014,92.7,4
1245,2003,72.4,2005,68.1,2
1245,2007,100,2008,98.4,1
1245,2008,98.4,2010,95,2
1245,2010,95,2014,94.9,4
1246,1976,100,2003,74.8,27
1246,2003,74.8,2005,74.8,2
1246,2005,74.8,2007,60.8,2
1246,2007,60.8,2008,60.8,1
1246,2008,60.8,2010,60.7,2
1246,2010,60.7,2012,58.5,2
1246,2012,58.5,2014,56.2,2
1246,2014,56.2,2016,53,2
1247,2003,52,2005,52,2
1247,2005,52,2007,24.2,2
1247,2010,99.2,2014,98.8,4
1248,1962,100,2003,72.9,41
1248,2005,73.3,2007,70.5,2
1248,2008,71,2010,69.2,2
1248,2012,69.7,2014,69.2,2
1248,2014,69.2,2016,67.8,2
1249,1970,100,2003,74.2,33
1249,2003,74.2,2005,65,2
1249,2008,69.5,2010,68.9,2
1249,2010,68.9,2012,68.7,2
1249,2012,68.7,2014,67.5,2
1249,2014,67.5,2016,65.2,2
1250,1992,100,2001,74.1,9
1250,2003,99.2,2005,74.5,2
1250,2007,86.1,2008,86.1,1
1250,2008,86.1,2010,84.3,2
1250,2012,86.7,2014,84.1,2
1250,2014,84.1,2016,75.1,2
1251,1930,100,2003,73.4,73
1251,2005,75.3,2007,60.5,2
1251,2012,68.4,2014,68,2
1251,2014,68,2016,63.6,2
1252,1938,100,2003,80.3,65
1252,2003,80.3,2005,77.7,2
1252,2005,77.7,2007,69.5,2
1252,2007,69.5,2008,68.4,1
1252,2008,68.4,2010,64.9,2
1252,2012,65.9,2014,64.8,2
1252,2014,64.8,2016,64.8,2
1253,2003,75,2005,72.3,2
1253,2005,72.3,2007,57.1,2
1253,2014,99.4,2016,97.8,2
1254,1998,100,2003,75,5
1254,2003,75,2005,75,2
1254,2005,75,2007,75,2
1254,2007,75,2008,75,1
1254,2014,77.9,2016,77.7,2
1255,2002,100,2003,75,1
1255,2003,75,2005,75,2
1255,2007,94.3,2009,74.8,2
1255,2013,94.6,2017,82.3,4
1256,1999,100,2003,100,4
1256,2003,100,2005,97.7,2
1256,2005,97.7,2007,97.4,2
1256,2007,97.4,2009,97.1,2
1256,2013,98.7,2017,81.4,4
1257,1940,100,2003,73.8,63
1257,2003,73.8,2005,73.8,2
1257,2005,73.8,2007,73.8,2
1257,2007,73.8,2008,73.5,1
1257,2008,73.5,2010,72,2
1257,2014,72.8,2016,72,2
1258,1965,100,2003,72.8,38
1258,2007,73.5,2008,72.8,1
1258,2008,72.8,2010,72.7,2
1258,2010,72.7,2014,71.9,4
1258,2014,71.9,2016,71.6,2
1259,2009,100,2010,100,1
1259,2010,100,2012,99.8,2
1259,2012,99.8,2014,99.7,2
1259,2014,99.7,2016,90.7,2
1260,2002,100,2003,99,1
1260,2006,99.4,2008,97.6,2
1260,2008,97.6,2010,97.6,2
1260,2010,97.6,2012,97.5,2
1260,2012,97.5,2014,97,2
1260,2014,97,2016,83.5,2
1261,1987,100,2003,83.1,16
1261,2003,83.1,2004,81.3,1
1261,2006,84.1,2008,84,2
1261,2008,84,2010,79.6,2
1261,2010,79.6,2012,70.3,2
1261,2012,70.3,2014,67.7,2
1261,2014,67.7,2016,67.5,2
1262,2003,33.1,2004,31.1,1
1262,2006,47.6,2008,46.6,2
1262,2008,46.6,2010,46.6,2
1262,2012,99.2,2014,98.7,2
1262,2014,98.7,2016,92.2,2
1263,1959,100,2001,68.7,42
1263,2003,72.7,2005,71.7,2
1263,2007,73.3,2008,72.1,1
1263,2008,72.1,2010,71.2,2
1263,2010,71.2,2012,70.5,2
1263,2012,70.5,2014,69.9,2
1263,2014,69.9,2016,69.1,2
1264,1970,100,2003,72.6,33
1264,2003,72.6,2005,52.4,2
1264,2011,61.4,2016,59.9,5
1265,1953,100,2003,93.6,50
1265,2003,93.6,2004,90.8,1
1265,2004,90.8,2006,76.3,2
1265,2006,76.3,2008,75.8,2
1265,2010,75.9,2012,73.4,2
1265,2012,73.4,2014,72.5,2
1265,2014,72.5,2016,72.3,2
1266,2003,63.5,2005,63.5,2
1266,2007,100,2008,99.9,1
1266,2008,99.9,2010,96.6,2
1266,2010,96.6,2012,96.2,2
1266,2012,96.2,2014,95.5,2
1266,2014,95.5,2016,86,2
1267,2003,68.8,2005,65.5,2
1267,2012,95.8,2014,94.3,2
1267,2014,94.3,2016,85.5,2
1268,1989,100,2001,63.5,12
1268,2005,73.2,2007,73.1,2
1268,2008,75.8,2010,73.2,2
1268,2010,73.2,2012,73,2
1268,2012,73,2014,72.2,2
1268,2014,72.2,2016,71.6,2
1269,1973,100,2001,67.5,28
1269,2003,70.4,2005,56.1,2
1269,2007,63.8,2008,63.2,1
1269,2008,63.2,2010,63,2
1269,2012,63.3,2014,63.3,2
1269,2014,63.3,2016,60.2,2
1270,1997,100,2003,70.8,6
1271,1997,100,2003,100,6
1271,2003,100,2005,75,2
1272,1998,100,2003,100,5
1272,2003,100,2005,92,2
1272,2007,93.3,2008,91.9,1
1272,2008,91.9,2010,91.5,2
1273,1999,100,2003,100,4
1273,2003,100,2005,92.5,2
1273,2008,95.6,2010,95.4,2
1274,1937,100,2003,59.9,66
1274,2003,59.9,2004,56.7,1
1274,2008,65.6,2010,61.7,2
1274,2012,62.9,2014,61.8,2
1274,2014,61.8,2016,61.8,2
1275,1963,100,2003,64.2,40
1275,2003,64.2,2004,62.6,1
1275,2012,65.3,2014,63.3,2
1275,2014,63.3,2016,62.7,2
1276,1938,100,2001,52.9,63
1276,2003,64,2006,63.6,3
1276,2007,63.9,2008,62.1,1
1276,2010,62.2,2012,61.8,2
1276,2012,61.8,2014,61.8,2
1276,2014,61.8,2016,59.9,2
1277,2003,2,2004,2,1
1277,2006,98.9,2008,93.5,2
1277,2008,93.5,2010,93.5,2
1277,2010,93.5,2014,93,4
1278,1937,100,2003,68,66
1278,2003,68,2004,66.8,1
1278,2004,66.8,2006,57.8,2
1278,2008,60.4,2010,59.3,2
1278,2010,59.3,2012,58.6,2
1278,2012,58.6,2014,56.9,2
1278,2014,56.9,2016,56,2
1279,1992,100,2002,98.3,10
1279,2002,98.3,2003,94.6,1
1279,2003,94.6,2005,75.8,2
1279,2006,93.4,2008,86.9,2
1279,2008,86.9,2010,86.6,2
1279,2010,86.6,2012,86.3,2
1279,2012,86.3,2014,81.5,2
1279,2014,81.5,2016,75.2,2
1280,1949,100,2003,72.9,54
1280,2005,73.2,2007,72.3,2
1280,2007,72.3,2008,72.3,1
1280,2008,72.3,2010,71.3,2
1280,2010,71.3,2014,70.7,4
1280,2014,70.7,2016,70.4,2
1281,1966,100,2005,68.1,39
1281,2006,71.9,2008,70.7,2
1281,2008,70.7,2010,70.1,2
1281,2010,70.1,2014,70.1,4
1282,1962,100,2005,71.7,43
1282,2005,71.7,2006,70.1,1
1282,2006,70.1,2008,70.1,2
1282,2008,70.1,2010,67.5,2
1282,2010,67.5,2012,66.9,2
1283,2003,65.9,2005,62.2,2
1283,2008,70.6,2010,68.5,2
1283,2012,99.8,2014,99.2,2
1283,2014,99.2,2016,94.2,2
1284,2010,100,2012,98.9,2
1284,2012,98.9,2014,98,2
1284,2014,98,2016,91.6,2
1285,2008,65.5,2010,65,2
1285,2012,99.6,2014,98.5,2
1285,2014,98.5,2016,93.4,2
1286,2010,100,2012,99.4,2
1286,2012,99.4,2014,98.8,2
1286,2014,98.8,2016,92.1,2
1287,2002,77.1,2003,66.1,1
1287,2003,66.1,2005,65.8,2
1287,2008,69,2010,69,2
1287,2012,99.5,2014,99,2
1287,2014,99,2016,92.3,2
1288,1989,100,2005,69.3,16
1288,2008,70.1,2010,68.8,2
1288,2010,68.8,2012,67,2
1289,1995,100,2005,69.6,10
1289,2006,92.5,2008,84.8,2
1289,2008,84.8,2010,84.1,2
1289,2014,86.3,2016,78.6,2
1290,1975,100,2002,61.5,27
1290,2003,78.3,2005,74.4,2
1290,2005,74.4,2006,74.2,1
1290,2006,74.2,2008,74.2,2
1290,2010,74.3,2012,73.3,2
1290,2012,73.3,2014,73.2,2
1290,2014,73.2,2016,70.6,2
1291,1975,100,2002,72.6,27
1291,2002,72.6,2003,69.8,1
1291,2003,69.8,2005,69.7,2
1291,2006,70.3,2008,70.3,2
1291,2008,70.3,2010,70.2,2
1291,2010,70.2,2012,69,2
1291,2012,69,2014,68.5,2
1291,2014,68.5,2016,65.5,2
1292,2002,74.4,2003,72.9,1
1292,2003,72.9,2005,59.1,2
1292,2008,68.3,2010,67.9,2
1292,2012,98.1,2014,95.4,2
1292,2014,95.4,2016,89.3,2
1293,1959,100,2003,75,44
1293,2003,75,2004,74.9,1
1293,2004,74.9,2006,69,2
1293,2008,71.5,2010,71,2
1293,2010,71,2012,66.8,2
1293,2014,67.6,2016,67.4,2
1294,2002,68.3,2003,67.8,1
1294,2003,67.8,2005,66.3,2
1294,2010,98.6,2012,98.1,2
1294,2012,98.1,2014,97.5,2
1294,2014,97.5,2016,89.7,2
1295,2009,100,2012,98.4,3
1295,2012,98.4,2014,97.7,2
1295,2014,97.7,2016,91,2
1296,1993,100,2005,74.3,12
1296,2006,81.7,2008,79.6,2
1296,2008,79.6,2010,79.4,2
1296,2010,79.4,2014,77.7,4
1296,2014,77.7,2016,74.4,2
1297,1931,100,2002,58,71
1297,2002,58,2003,49.7,1
1297,2003,49.7,2005,49.7,2
1297,2008,63.4,2010,59.2,2
1297,2010,59.2,2012,53.8,2
1297,2012,53.8,2014,52.7,2
1297,2014,52.7,2016,51.9,2
1298,2004,100,2005,75.8,1
1298,2005,75.8,2006,75.6,1
1298,2008,96.8,2010,96.1,2
1299,1919,100,2002,40.9,83
1299,2008,63.2,2010,61.4,2
1299,2010,61.4,2012,57.2,2
1299,2012,57.2,2014,55.3,2
1299,2014,55.3,2016,50.9,2
1300,1930,100,2002,61,72
1300,2002,61,2003,59.8,1
1300,2003,59.8,2005,51.5,2
1300,2008,62.9,2010,62.3,2
1300,2010,62.3,2012,61.1,2
1300,2012,61.1,2014,60.9,2
1300,2014,60.9,2016,59.8,2
1301,1916,100,2002,62.2,86
1301,2002,62.2,2003,57.6,1
1301,2003,57.6,2005,52.6,2
1301,2010,71.5,2012,66.9,2
1301,2012,66.9,2014,66.5,2
1301,2014,66.5,2016,66.1,2
1302,1916,100,2002,40.8,86
1302,2003,43.3,2005,36.3,2
1302,2010,71.5,2012,70.1,2
1302,2012,70.1,2014,69.4,2
1302,2014,69.4,2016,69.2,2
1303,1916,100,2002,38.9,86
1303,2008,68.9,2010,65.4,2
1303,2010,65.4,2012,64.8,2
1303,2012,64.8,2014,64,2
1303,2014,64,2016,63.8,2
1304,1975,100,2003,95.6,28
1304,2003,95.6,2004,75.9,1
1304,2006,87.2,2008,87.1,2
1304,2008,87.1,2010,84.2,2
1304,2010,84.2,2012,79.6,2
1304,2012,79.6,2014,79.1,2
1304,2014,79.1,2016,73,2
1305,2011,100,2012,99.7,1
1305,2012,99.7,2014,99.2,2
1305,2014,99.2,2016,93.5,2
1306,1974,100,2002,88.2,28
1306,2002,88.2,2003,74.9,1
1306,2003,74.9,2005,74.6,2
1306,2005,74.6,2006,73,1
1306,2008,74.4,2010,74,2
1306,2014,75.7,2016,73.2,2
1307,1975,100,2002,83,27
1307,2003,83.1,2005,82.5,2
1307,2005,82.5,2006,73.5,1
1307,2006,73.5,2008,72.9,2
1307,2008,72.9,2010,72.7,2
1307,2012,78.2,2014,76.7,2
1307,2014,76.7,2016,75.9,2
1308,1987,100,2005,40,18
1308,2006,85.4,2008,78.7,2
1308,2008,78.7,2010,74.8,2
1308,2010,74.8,2012,70,2
1308,2014,71.1,2016,51.3,2
1309,1986,100,2001,73.4,15
1309,2001,73.4,2003,72.7,2
1309,2007,76.7,2008,76.6,1
1309,2010,78.7,2012,75.4,2
1309,2012,75.4,2014,75.3,2
1309,2014,75.3,2016,75.2,2
1310,1986,100,2001,72.8,15
1310,2003,87.3,2005,86.8,2
1310,2005,86.8,2007,76.5,2
1310,2007,76.5,2008,75.5,1
1310,2008,75.5,2010,74.9,2
1310,2012,75,2014,74.9,2
1310,2014,74.9,2016,74.6,2
1311,2006,100,2012,97.9,6
1311,2012,97.9,2014,97.3,2
1311,2014,97.3,2016,87.6,2
1312,1990,100,2002,95,12
1312,2002,95,2003,93.1,1
1312,2003,93.1,2005,74.2,2
1312,2005,74.2,2006,74.2,1
1312,2007,79.6,2008,79.1,1
1312,2008,79.1,2010,75.2,2
1312,2010,75.2,2012,75,2
1312,2012,75,2014,74.2,2
1313,2002,93.9,2003,91.2,1
1313,2003,91.2,2005,74.6,2
1313,2005,74.6,2006,74.6,1
1313,2008,99.9,2010,98.9,2
1313,2010,98.9,2012,98.2,2
1313,2012,98.2,2014,98,2
1313,2014,98,2016,89.2,2
1314,1957,100,2003,72.9,46
1314,2003,72.9,2005,72.9,2
1314,2005,72.9,2007,70.1,2
1314,2008,71.2,2010,70.8,2
1314,2010,70.8,2012,70.8,2
1314,2014,75.5,2016,69.9,2
1315,1997,100,2003,75,6
1315,2008,92.9,2010,92.9,2
1315,2010,92.9,2014,91.7,4
1315,2014,91.7,2016,89.9,2
1316,2001,100,2005,75,4
1316,2006,80.6,2008,80.5,2
1317,2000,100,2005,75,5
1317,2006,83.9,2008,83.8,2
1318,1970,100,2005,73.3,35
1318,2005,73.3,2006,54.8,1
1318,2006,54.8,2008,54.4,2
1318,2014,62.5,2016,61.4,2
1319,1960,100,2005,66.4,45
1319,2005,66.4,2006,43.6,1
1319,2006,43.6,2008,41.9,2
1319,2012,65.6,2014,64.7,2
1319,2014,64.7,2016,63.7,2
1320,1960,100,2003,73.5,43
1320,2003,73.5,2005,72.7,2
1320,2007,74.5,2008,74.5,1
1320,2008,74.5,2010,74.4,2
1320,2010,74.4,2012,74.4,2
1320,2014,76.4,2016,70.2,2
1321,1993,100,2003,75,10
1321,2003,75,2005,74.8,2
1321,2007,92,2008,91.9,1
1321,2010,94.7,2014,91.9,4
1321,2014,91.9,2016,76.2,2
1322,2003,75,2005,63.6,2
1322,2007,66.4,2008,66.3,1
1323,1963,100,2003,75,40
1323,2003,75,2004,70.7,1
1323,2004,70.7,2006,57,2
1323,2010,59.1,2012,58.4,2
1323,2012,58.4,2014,56.8,2
1323,2014,56.8,2016,55.6,2
1324,1963,100,2003,68.5,40
1324,2003,68.5,2004,63.5,1
1324,2004,63.5,2006,57.3,2
1324,2006,57.3,2008,53.5,2
1324,2008,53.5,2010,53.5,2
1324,2010,53.5,2012,49.3,2
1324,2012,49.3,2014,49.3,2
1324,2014,49.3,2016,48.9,2
1325,2003,64.4,2005,39.6,2
1325,2005,39.6,2007,31.2,2
1325,2010,98.8,2014,96.7,4
1326,1993,100,2003,77.8,10
1326,2003,77.8,2004,67.2,1
1326,2006,70,2008,70,2
1326,2008,70,2010,67.4,2
1326,2010,67.4,2012,63.1,2
1326,2012,63.1,2014,63,2
1326,2014,63,2016,62.9,2
1327,1988,100,2003,74.7,15
1327,2003,74.7,2005,74.5,2
1327,2014,90.8,2016,88.9,2
1328,2003,50.3,2005,48.1,2
1328,2007,53.3,2008,48.8,1
1328,2008,48.8,2010,44.7,2
1328,2012,98.8,2016,86.3,4
1329,2003,65.2,2004,61.3,1
1329,2006,99.4,2008,98.8,2
1329,2008,98.8,2010,97.5,2
1329,2014,98.3,2016,97.4,2
1330,2006,75,2008,56.1,2
1330,2008,56.1,2010,55.7,2
1330,2010,55.7,2012,51.6,2
1330,2012,51.6,2014,51.6,2
1330,2014,51.6,2016,51.6,2
1331,2003,100,2005,75,2
1331,2006,100,2007,99.9,1
1331,2007,99.9,2008,98.9,1
1331,2008,98.9,2010,95.4,2
1332,2003,100,2005,75,2
1332,2006,99.4,2008,96.6,2
1332,2008,96.6,2010,96.4,2
1333,2005,61.9,2006,53.3,1
1333,2008,53.6,2010,50.5,2
1333,2010,50.5,2012,16.3,2
1333,2014,98.8,2016,95.9,2
1334,2006,24.3,2008,24.3,2
1334,2010,99.7,2014,99.6,4
1335,2010,38.2,2012,38.2,2
1335,2014,98.4,2016,95.3,2
1336,1970,100,2005,73.5,35
1336,2005,73.5,2006,72.1,1
1336,2006,72.1,2008,70.2,2
1336,2008,70.2,2010,66.5,2
1336,2012,69.4,2014,68.5,2
1336,2014,68.5,2016,64.2,2
1337,2001,100,2005,74.1,4
1337,2006,96.6,2008,86.8,2
1338,2001,100,2005,75,4
1338,2006,99.2,2008,87.9,2
1338,2008,87.9,2010,87.7,2
1339,1999,100,2005,74.5,6
1339,2010,96.1,2014,94.7,4
1340,1999,100,2005,74.6,6
1340,2005,74.6,2006,70.5,1
1340,2006,70.5,2008,60.4,2
1340,2008,60.4,2010,60.4,2
1340,2010,60.4,2012,59.3,2
1340,2012,59.3,2014,59.2,2
1340,2014,59.2,2016,59.2,2
1341,1999,100,2005,98.7,6
1341,2006,99.5,2008,95.4,2
1341,2008,95.4,2010,93.9,2
1342,1999,100,2005,92.7,6
1342,2006,98.9,2008,96,2
1342,2008,96,2010,94.2,2
1343,2003,100,2005,80.7,2
1343,2007,98.6,2008,98.6,1
1343,2008,98.6,2010,92.5,2
1344,2002,100,2005,99.7,3
1344,2005,99.7,2007,96.8,2
1344,2007,96.8,2008,96.4,1
1344,2008,96.4,2010,95.7,2
1345,1970,100,2003,75,33
1345,2003,75,2005,75,2
1345,2005,75,2007,70.7,2
1345,2007,70.7,2008,70.7,1
1345,2008,70.7,2010,70.7,2
1345,2010,70.7,2014,68.7,4
1345,2014,68.7,2016,68.3,2
1346,1957,100,2003,75,46
1346,2003,75,2005,73.1,2
1346,2007,77.9,2008,77.4,1
1346,2010,78.1,2012,78.1,2
1346,2012,78.1,2014,75.2,2
1346,2014,75.2,2016,74.6,2
1347,1993,100,2003,74.6,10
1347,2003,74.6,2005,73.7,2
1347,2007,74.2,2008,73.5,1
1347,2014,75.4,2016,74.9,2
1348,1960,100,2003,73.7,43
1348,2003,73.7,2005,70.1,2
1348,2005,70.1,2007,67.1,2
1348,2007,67.1,2008,67.1,1
1348,2008,67.1,2010,66.7,2
1348,2010,66.7,2012,65.7,2
1348,2014,75.3,2016,74.9,2
1349,1993,100,2003,75,10
1349,2003,75,2005,74.9,2
1349,2007,96.8,2008,95.7,1
1349,2010,95.8,2014,92.9,4
1349,2014,92.9,2016,76,2
1350,2003,74,2005,71.6,2
1350,2007,73.2,2008,73.2,1
1350,2008,73.2,2010,72.6,2
1350,2010,72.6,2012,72.6,2
1350,2014,99.5,2016,99.5,2
1351,1993,100,2003,74.8,10
1351,2003,74.8,2005,74.1,2
1351,2007,98.4,2008,97.9,1
1351,2010,98.8,2014,95.7,4
1351,2014,95.7,2016,94.9,2
1352,2006,100,2012,98.3,6
1352,2012,98.3,2014,98.2,2
1352,2014,98.2,2016,87.5,2
1353,1997,100,2001,94.2,4
1353,2003,94.7,2005,75.6,2
1353,2007,96.2,2008,93,1
1353,2008,93,2010,90.7,2
1353,2010,90.7,2012,89.2,2
1353,2014,89.7,2016,79.6,2
1354,1960,100,2005,56.1,45
1354,2005,56.1,2007,56.1,2
1354,2007,56.1,2008,53.2,1
1354,2008,53.2,2010,52,2
1354,2010,52,2012,44.1,2
1354,2012,44.1,2014,42.6,2
1354,2014,42.6,2016,42.6,2
1355,1997,100,2001,79.3,4
1355,2007,97.3,2008,95.7,1
1355,2008,95.7,2010,94.4,2
1355,2010,94.4,2012,92.1,2
1355,2014,92.8,2016,79.3,2
1356,1957,100,2003,69,46
1356,2005,69.5,2007,66.6,2
1356,2007,66.6,2008,65,1
1356,2008,65,2010,61.2,2
1356,2010,61.2,2012,57.5,2
1356,2012,57.5,2014,56.6,2
1356,2014,56.6,2016,56.6,2
1357,1997,100,2003,100,6
1357,2003,100,2005,75,2
1357,2007,94.4,2008,94.4,1
1358,2001,100,2003,99.4,2
1358,2003,99.4,2005,97.2,2
1358,2005,97.2,2007,96.6,2
1358,2008,96.8,2010,94.8,2
1358,2010,94.8,2012,92.3,2
1358,2012,92.3,2014,87.7,2
1358,2014,87.7,2016,78.7,2
1359,2001,100,2003,99.8,2
1359,2003,99.8,2005,97.2,2
1359,2005,97.2,2007,95.9,2
1359,2008,96.5,2010,96,2
1359,2010,96,2012,95.2,2
1359,2012,95.2,2014,92,2
1359,2014,92,2016,80.6,2
1360,2000,100,2003,99.7,3
1360,2003,99.7,2005,98.6,2
1360,2005,98.6,2007,98.1,2
1360,2007,98.1,2008,98.1,1
1360,2008,98.1,2010,97.8,2
1360,2010,97.8,2012,96.6,2
1360,2012,96.6,2014,94.9,2
1360,2014,94.9,2016,81.6,2
1361,2000,100,2003,99.6,3
1361,2003,99.6,2005,98.9,2
1361,2005,98.9,2007,98.4,2
1361,2008,98.6,2010,98.4,2
1361,2010,98.4,2012,96.7,2
1361,2012,96.7,2014,94.7,2
1361,2014,94.7,2016,81.6,2
1362,2001,100,2003,98.9,2
1362,2003,98.9,2005,98.6,2
1362,2005,98.6,2007,93.8,2
1362,2007,93.8,2008,91.5,1
1362,2010,95.5,2012,93.9,2
1362,2012,93.9,2014,91.1,2
1362,2014,91.1,2016,81.1,2
1363,2008,100,2012,99.4,4
1363,2012,99.4,2014,99.2,2
1363,2014,99.2,2016,90.6,2
1364,2008,100,2012,99,4
1364,2012,99,2014,98.7,2
1364,2014,98.7,2016,90.5,2
1365,2004,100,2005,75,1
1365,2006,97.8,2008,94.6,2
1365,2008,94.6,2010,90.2,2
1366,2001,100,2005,98.6,4
1366,2005,98.6,2007,97.5,2
1366,2007,97.5,2008,94.7,1
1366,2010,96.9,2012,93.5,2
1366,2012,93.5,2014,91,2
1366,2014,91,2016,80.2,2
1367,2002,100,2003,98.6,1
1367,2003,98.6,2005,74.6,2
1367,2006,98.3,2008,96.8,2
1367,2010,97.7,2012,95.5,2
1367,2012,95.5,2014,93.3,2
1367,2014,93.3,2016,81,2
1368,2002,100,2003,99.3,1
1368,2003,99.3,2005,75.5,2
1368,2006,99.6,2008,93.8,2
1368,2008,93.8,2010,93.6,2
1368,2010,93.6,2012,91.8,2
1368,2012,91.8,2014,90.3,2
1368,2014,90.3,2016,80.5,2
1369,2002,100,2003,99.8,1
1369,2003,99.8,2005,74.9,2
1369,2006,97.8,2008,96.8,2
1369,2010,97.7,2012,96.6,2
1369,2012,96.6,2014,95.6,2
1369,2014,95.6,2016,83.3,2
1370,2003,98.7,2005,81.1,2
1370,2008,98.1,2010,93.3,2
1370,2010,93.3,2012,88.4,2
1370,2012,88.4,2014,87,2
1370,2014,87,2016,82.3,2
1371,2003,98.1,2005,73.7,2
1371,2006,93.2,2008,85.3,2
1371,2010,85.5,2012,84.8,2
1371,2012,84.8,2014,83.3,2
1371,2014,83.3,2016,80.7,2
1372,2000,100,2003,99.9,3
1372,2003,99.9,2005,75,2
1372,2008,98.9,2010,97.8,2
1372,2010,97.8,2012,97.3,2
1372,2012,97.3,2014,96.2,2
1372,2014,96.2,2016,85.7,2
1373,2000,100,2003,99.8,3
1373,2003,99.8,2005,74.9,2
1373,2006,99.3,2008,99.2,2
1373,2008,99.2,2010,98.1,2
1373,2010,98.1,2012,97.5,2
1373,2012,97.5,2014,96.4,2
1373,2014,96.4,2016,80.7,2
1374,2003,99.5,2005,74.7,2
1374,2006,94.1,2008,93.8,2
1374,2008,93.8,2010,93.7,2
1374,2010,93.7,2012,93.4,2
1374,2012,93.4,2014,92.8,2
1374,2014,92.8,2016,82.1,2
1375,2003,99.8,2005,74.9,2
1375,2008,97.3,2010,97.3,2
1375,2010,97.3,2012,95.9,2
1375,2012,95.9,2014,95.2,2
1375,2014,95.2,2016,82.9,2
1376,2003,99.8,2005,74.9,2
1376,2006,96.9,2008,93.6,2
1376,2010,97.8,2012,94.4,2
1376,2012,94.4,2014,93.8,2
1376,2014,93.8,2016,83.2,2
1377,2001,100,2003,99.8,2
1377,2003,99.8,2005,73.8,2
1377,2006,97.4,2008,88.3,2
1377,2010,95.9,2012,93.6,2
1377,2012,93.6,2014,91.5,2
1377,2014,91.5,2016,80.6,2
1378,2001,100,2002,100,1
1378,2002,100,2003,99.5,1
1378,2003,99.5,2005,74.7,2
1378,2010,98.8,2012,97.4,2
1378,2012,97.4,2014,93.4,2
1378,2014,93.4,2016,80.5,2
1379,1999,100,2002,100,3
1379,2002,100,2003,99.5,1
1379,2003,99.5,2005,74.6,2
1379,2010,97,2012,94.3,2
1379,2012,94.3,2014,91.2,2
1379,2014,91.2,2016,80,2
1380,1999,100,2002,100,3
1380,2002,100,2003,99.9,1
1380,2003,99.9,2005,74.5,2
1380,2008,98.6,2010,98.1,2
1380,2010,98.1,2012,95.6,2
1380,2012,95.6,2014,92.9,2
1380,2014,92.9,2016,80.6,2
1381,2001,100,2002,98.9,1
1381,2002,98.9,2003,96.9,1
1381,2003,96.9,2005,74.4,2
1381,2006,88.5,2008,84.3,2
1381,2010,87,2012,83.6,2
1381,2012,83.6,2014,82.3,2
1381,2014,82.3,2016,76.3,2
1382,2001,100,2002,99.2,1
1382,2002,99.2,2003,97.5,1
1382,2003,97.5,2005,74.7,2
1382,2006,89.2,2008,87.6,2
1382,2008,87.6,2010,87.6,2
1382,2010,87.6,2012,84,2
1382,2012,84,2014,82.6,2
1382,2014,82.6,2016,76.3,2
1383,2001,100,2002,100,1
1383,2002,100,2003,99.9,1
1383,2003,99.9,2005,74.9,2
1383,2006,99.5,2008,98.6,2
1383,2008,98.6,2010,98.4,2
1383,2010,98.4,2012,96.6,2
1383,2012,96.6,2014,94.8,2
1383,2014,94.8,2016,81.8,2
1384,2008,100,2012,99.1,4
1384,2012,99.1,2014,98,2
1384,2014,98,2016,87.1,2
1385,2005,100,2006,99.3,1
1385,2006,99.3,2008,95.6,2
1385,2008,95.6,2010,93.9,2
1385,2012,94.5,2014,94,2
1385,2014,94,2016,84,2
1386,2004,100,2006,99.8,2
1386,2008,99.9,2010,98.2,2
1386,2010,98.2,2012,97.5,2
1386,2014,97.8,2016,83.8,2
1387,2004,100,2006,99.6,2
1387,2008,99.9,2010,97.7,2
1387,2010,97.7,2012,97.5,2
1387,2012,97.5,2014,97.4,2
1387,2014,97.4,2016,83.1,2
1388,2005,100,2006,99.3,1
1388,2008,99.4,2010,97.2,2
1388,2012,97.3,2014,97.2,2
1388,2014,97.2,2016,85.4,2
1389,2008,100,2012,99.7,4
1389,2012,99.7,2014,99.5,2
1389,2014,99.5,2016,89.5,2
1390,2009,100,2012,99.3,3
1390,2012,99.3,2014,98.9,2
1390,2014,98.9,2016,88.3,2
1391,2009,100,2012,99.4,3
1391,2012,99.4,2014,99,2
1391,2014,99,2016,88.4,2
1392,2008,100,2012,98.4,4
1392,2012,98.4,2014,98.2,2
1392,2014,98.2,2016,90.1,2
1393,2008,100,2012,97.6,4
1393,2014,98.2,2016,90.3,2
1394,2009,100,2010,98.9,1
1394,2010,98.9,2012,97.5,2
1394,2012,97.5,2014,97.2,2
1394,2014,97.2,2016,89.9,2
1395,2011,100,2012,95.7,1
1395,2012,95.7,2014,95.3,2
1395,2014,95.3,2016,92.6,2
1396,2011,100,2012,99.8,1
1396,2012,99.8,2014,99.3,2
1396,2014,99.3,2016,92.5,2
1397,2011,100,2012,99.8,1
1397,2012,99.8,2014,99.3,2
1397,2014,99.3,2016,93.3,2
1398,2007,100,2012,98.9,5
1398,2012,98.9,2014,98.9,2
1398,2014,98.9,2016,89.2,2
1399,2001,100,2003,99.5,2
1399,2003,99.5,2005,74.8,2
1399,2008,97.7,2010,96.9,2
1399,2010,96.9,2012,94.9,2
1399,2012,94.9,2014,93.3,2
1399,2014,93.3,2016,80.8,2
1400,2000,100,2005,74.3,5
1400,2006,95.6,2008,85.9,2
1400,2010,87.1,2014,86.4,4
1400,2014,86.4,2016,79.2,2
1401,2007,100,2012,87.3,5
1401,2012,87.3,2014,87.1,2
1401,2014,87.1,2016,79.1,2
1402,2007,100,2012,87.6,5
1402,2012,87.6,2014,86.7,2
1402,2014,86.7,2016,79.8,2
1403,2008,100,2012,97.9,4
1403,2012,97.9,2014,97.8,2
1403,2014,97.8,2016,89.7,2
1404,2008,100,2012,96.1,4
1404,2012,96.1,2014,95.8,2
1404,2014,95.8,2016,88.8,2
1405,2009,100,2012,99,3
1405,2012,99,2014,97.8,2
1405,2014,97.8,2016,90.3,2
1406,2009,100,2012,98.2,3
1406,2012,98.2,2014,97.3,2
1406,2014,97.3,2016,89.7,2
1407,2009,100,2012,99.5,3
1407,2012,99.5,2014,98.5,2
1407,2014,98.5,2016,91.2,2
1408,2009,100,2012,99.4,3
1408,2012,99.4,2014,98.3,2
1408,2014,98.3,2016,90.8,2
1409,2009,100,2012,98.7,3
1409,2012,98.7,2014,97.9,2
1409,2014,97.9,2016,89.2,2
1410,2009,100,2012,98.5,3
1410,2012,98.5,2014,98,2
1410,2014,98,2016,93.7,2
1411,2006,100,2012,97.5,6
1411,2012,97.5,2014,97.4,2
1411,2014,97.4,2016,87.3,2
1412,2006,100,2012,97.9,6
1412,2012,97.9,2014,97.6,2
1412,2014,97.6,2016,87.5,2
1413,2008,100,2012,99.2,4
1413,2012,99.2,2014,98.7,2
1413,2014,98.7,2016,89.9,2
1414,2007,100,2012,98.9,5
1414,2012,98.9,2014,98,2
1414,2014,98,2016,88.6,2
1415,2008,100,2010,99.3,2
1415,2010,99.3,2012,98.8,2
1415,2012,98.8,2014,97.7,2
1415,2014,97.7,2016,89.5,2
1416,2008,100,2012,98.7,4
1416,2012,98.7,2014,98.4,2
1416,2014,98.4,2016,88,2
1417,2008,100,2012,98.7,4
1417,2012,98.7,2014,98.5,2
1417,2014,98.5,2016,88.2,2
1418,2009,100,2010,100,1
1418,2010,100,2012,99.3,2
1418,2012,99.3,2014,98.8,2
1418,2014,98.8,2016,91.9,2
1419,2009,100,2012,99.1,3
1419,2012,99.1,2014,98.5,2
1419,2014,98.5,2016,91.1,2
1420,2008,100,2012,99.1,4
1420,2012,99.1,2014,98.8,2
1420,2014,98.8,2016,90.1,2
1421,2008,100,2012,99,4
1421,2012,99,2014,98.6,2
1421,2014,98.6,2016,88.4,2
1422,2009,100,2012,99.3,3
1422,2012,99.3,2014,98.4,2
1422,2014,98.4,2016,91.2,2
1423,2010,100,2012,95,2
1423,2012,95,2014,91,2
1423,2014,91,2016,84.5,2
1424,2009,100,2012,98.9,3
1424,2012,98.9,2014,98.4,2
1424,2014,98.4,2016,91.2,2
1425,2009,100,2012,99.5,3
1425,2012,99.5,2014,98.5,2
1425,2014,98.5,2016,91.2,2
1426,2011,100,2012,99.7,1
1426,2012,99.7,2014,98.9,2
1426,2014,98.9,2016,92.9,2
1427,2010,100,2012,99.5,2
1427,2012,99.5,2014,99,2
1427,2014,99,2016,92.3,2
1428,2004,100,2006,98.6,2
1428,2008,99.4,2010,95.4,2
1428,2012,96.3,2014,95.6,2
1428,2014,95.6,2016,83.4,2
1429,2004,100,2006,99.3,2
1429,2006,99.3,2008,99.3,2
1429,2008,99.3,2010,98.4,2
1429,2010,98.4,2012,98.1,2
1429,2012,98.1,2014,97.7,2
1429,2014,97.7,2016,85.2,2
1430,2007,100,2012,98.2,5
1430,2014,98.4,2016,88.9,2
1431,2009,100,2012,99.6,3
1431,2012,99.6,2014,99.5,2
1431,2014,99.5,2016,92.1,2
1432,2009,100,2012,99.1,3
1432,2012,99.1,2014,98.5,2
1432,2014,98.5,2016,90.9,2
1433,2008,100,2012,99,4
1433,2012,99,2014,98.6,2
1433,2014,98.6,2016,89.4,2
1434,2010,100,2012,99.5,2
1434,2012,99.5,2014,98.9,2
1434,2014,98.9,2016,92.5,2
1435,2012,100,2014,99.6,2
1435,2014,99.6,2016,95.1,2
1436,2008,100,2012,99.2,4
1436,2012,99.2,2016,91.3,4
1437,2007,100,2012,98.5,5
1437,2012,98.5,2016,84.5,4
1438,2011,100,2012,99.9,1
1438,2012,99.9,2016,94.4,4
1439,2011,100,2012,99.9,1
1439,2012,99.9,2016,94.5,4
1440,1899,100,2010,36.9,111
1440,2012,100,2014,99.7,2
1441,2013,100,2014,99.5,1
1442,2012,100,2014,99.4,2
1443,2013,100,2014,99.8,1
1444,2008,100,2014,97.4,6
1444,2014,97.4,2016,90.5,2
1445,2001,28.1,2005,22.9,4
1445,2007,27.2,2008,24.4,1
1445,2008,24.4,2009,22.7,1
1445,2009,22.7,2010,21.7,1
1445,2012,98.5,2014,96.5,2
1445,2014,96.5,2016,92.3,2
1446,1978,100,2001,40,23
1446,2005,48,2009,44.4,4
1446,2009,44.4,2013,44.4,4
1446,2013,44.4,2015,44.4,2
1446,2015,44.4,2017,44.4,2
1447,1964,100,2001,54.4,37
1447,2005,65.9,2009,65.4,4
1447,2013,69,2015,58.7,2
1448,1960,100,2001,74,41
1448,2001,74,2005,63.7,4
1449,1972,100,2003,66.7,31
1449,2005,67.8,2007,64.7,2
1449,2007,64.7,2009,63.5,2
1449,2013,65.1,2015,64.8,2
1449,2015,64.8,2017,64.7,2
1450,2003,50.9,2004,45,1
1450,2004,45,2005,37.9,1
1450,2005,37.9,2006,36.7,1
1450,2006,36.7,2007,21.7,1
1450,2009,99.5,2010,99.2,1
1450,2010,99.2,2012,97.5,2
1450,2012,97.5,2014,94.4,2
1450,2014,94.4,2016,89.8,2
1451,1966,100,2003,66.2,37
1451,2005,70.8,2007,69.5,2
1451,2009,70.2,2011,69.1,2
1451,2011,69.1,2013,69,2
1451,2015,69.3,2017,69.3,2
1452,1983,100,2001,73.4,18
1452,2001,73.4,2003,69.1,2
1452,2003,69.1,2005,66.6,2
1452,2011,71.5,2013,71.4,2
1452,2015,72,2017,71.9,2
1453,1981,100,2001,54.4,20
1453,2003,73.4,2005,73.3,2
1453,2005,73.3,2007,67.5,2
1453,2013,70.9,2015,70.2,2
1454,1899,100,2001,41.8,102
1454,2001,41.8,2005,26.6,4
1454,2005,26.6,2009,24.7,4
1454,2015,31.3,2017,25.7,2
1455,2001,75,2005,53.3,4
1455,2005,53.3,2009,19.8,4
1455,2013,38,2015,35.3,2
1456,1899,100,2001,45.2,102
1456,2001,45.2,2005,30.1,4
1456,2007,44.4,2009,30.6,2
1456,2009,30.6,2011,28.8,2
1456,2013,31.7,2015,31.5,2
1456,2015,31.5,2017,31.5,2
1457,1899,100,2001,99.6,102
1457,2001,99.6,2005,53.8,4
1457,2009,72.9,2013,69.9,4
1457,2015,71.9,2017,71.1,2
1458,1899,100,2001,46.7,102
1458,2001,46.7,2005,44.5,4
1458,2009,45.2,2013,44.3,4
1459,1899,100,2001,0.6,102
1459,2015,70.4,2017,70.1,2
1460,1899,100,2001,74.8,102
1460,2001,74.8,2005,67.9,4
1460,2009,73.9,2013,73.9,4
1460,2013,73.9,2014,73.9,1
1460,2014,73.9,2015,73.1,1
1461,1899,100,2001,70.9,102
1461,2001,70.9,2005,65.5,4
1461,2013,71,2017,70.7,4
1462,1899,100,2001,71.8,102
1462,2001,71.8,2005,66,4
1462,2009,73.6,2013,71,4
1463,1899,100,2001,62,102
1463,2001,62,2005,48.1,4
1463,2009,67.1,2011,67.1,2
1463,2011,67.1,2013,63.9,2
1463,2013,63.9,2015,28.7,2
1463,2015,28.7,2017,28.5,2
1464,1899,100,2001,73.8,102
1464,2001,73.8,2005,57.1,4
1464,2009,72.9,2013,71.4,4
1464,2013,71.4,2017,71.2,4
1465,1899,100,2001,72.5,102
1465,2001,72.5,2005,64.9,4
1465,2005,64.9,2009,60.5,4
1465,2013,63.1,2015,63.1,2
1465,2015,63.1,2017,63.1,2
1466,1899,100,2001,43.3,102
1466,2001,43.3,2005,43.3,4
1466,2009,45.9,2013,45.5,4
1466,2013,45.5,2015,40.6,2
1466,2015,40.6,2017,40.6,2
1467,1899,100,2001,87.4,102
1467,2001,87.4,2005,56.1,4
1467,2009,56.3,2013,54.7,4
1467,2013,54.7,2015,54.7,2
1467,2015,54.7,2017,54.7,2
1468,1984,100,2001,74.8,17
1468,2001,74.8,2005,73.7,4
1468,2005,73.7,2009,73.4,4
1468,2013,74.8,2017,71.5,4
1469,1899,100,2001,75,102
1469,2001,75,2005,61.1,4
1469,2009,65.2,2013,65,4
1469,2013,65,2015,65,2
1470,1899,100,2001,74.1,102
1470,2001,74.1,2005,67.1,4
1470,2009,73.3,2013,71.5,4
1471,2001,74.9,2005,69.6,4
1471,2005,69.6,2009,26.7,4
1471,2009,26.7,2013,25.4,4
1471,2013,25.4,2015,20.3,2
1472,1899,100,2001,71.9,102
1472,2001,71.9,2005,52.4,4
1472,2005,52.4,2009,51.9,4
1472,2015,73.1,2017,73.1,2
1473,2009,32.9,2011,32,2
1473,2011,32,2013,32,2
1474,1985,100,2001,55.4,16
1474,2001,55.4,2005,50.7,4
1474,2009,65.4,2013,63.1,4
1474,2015,64.4,2017,62.7,2
1475,1985,100,2001,75,16
1475,2001,75,2005,55,4
1475,2005,55,2009,53.9,4
1475,2009,53.9,2013,52.5,4
1475,2013,52.5,2015,50.7,2
1475,2015,50.7,2017,50.7,2
1476,1899,100,2001,75,102
1476,2001,75,2005,44,4
1476,2009,51.4,2013,50.3,4
1476,2013,50.3,2014,45.3,1
1476,2014,45.3,2015,25.1,1
1476,2016,31,2017,31,1
1477,1899,100,2001,75,102
1477,2001,75,2005,48.4,4
1477,2005,48.4,2007,39.6,2
1477,2007,39.6,2009,39.6,2
1477,2009,39.6,2011,39.6,2
1477,2011,39.6,2013,39.5,2
1477,2015,39.6,2017,39.6,2
1478,1899,100,2001,58.2,102
1478,2001,58.2,2005,41.8,4
1478,2009,47.4,2013,46.5,4
1478,2015,51.2,2017,51.2,2
1479,1980,100,2005,64.5,25
1479,2009,70.2,2011,64.6,2
1479,2011,64.6,2013,64.1,2
1479,2013,64.1,2015,63.4,2
1479,2015,63.4,2017,61.4,2
1480,1980,100,2005,87.3,25
1480,2007,90.4,2009,78.3,2
1480,2009,78.3,2011,77.3,2
1480,2011,77.3,2013,70.2,2
1481,1899,100,2005,46.7,106
1481,2005,46.7,2007,43.9,2
1481,2011,57.9,2013,50.3,2
1481,2013,50.3,2015,36,2
1481,2015,36,2017,36,2
1482,1982,100,2004,64.6,22
1482,2006,72.3,2007,31.9,1
1482,2007,31.9,2009,30.8,2
1482,2009,30.8,2011,28.9,2
1482,2011,28.9,2013,28.3,2
1482,2013,28.3,2015,28,2
1482,2015,28,2017,28,2
1483,1982,100,2004,65.8,22
1483,2006,75,2007,75,1
1483,2007,75,2009,68.3,2
1483,2009,68.3,2011,68,2
1483,2011,68,2013,67.6,2
1483,2013,67.6,2015,67.1,2
1484,1982,100,2004,38.7,22
1484,2006,66.4,2007,60,1
1484,2007,60,2009,53.6,2
1484,2011,57.4,2013,57.2,2
1484,2013,57.2,2015,56,2
1485,1982,100,2006,75,24
1485,2006,75,2007,75,1
1485,2007,75,2009,69.9,2
1485,2011,71.2,2013,70.9,2
1485,2013,70.9,2015,70.1,2
1485,2015,70.1,2017,70.1,2
1486,1980,100,2003,75,23
1486,2003,75,2005,75,2
1486,2005,75,2007,75,2
1486,2007,75,2009,74.8,2
1486,2009,74.8,2013,74.1,4
1486,2013,74.1,2015,74.1,2
1486,2015,74.1,2017,74.1,2
1487,1958,100,2000,58.4,42
1487,2000,58.4,2004,55.3,4
1487,2006,64.3,2007,63,1
1487,2011,67.2,2013,66.5,2
1487,2013,66.5,2015,66,2
1487,2015,66,2017,63.7,2
1488,1993,100,2001,74.8,8
1488,2001,74.8,2003,74.8,2
1488,2003,74.8,2005,74.7,2
1488,2005,74.7,2007,74.7,2
1488,2009,88.1,2011,87.9,2
1488,2011,87.9,2013,87.8,2
1488,2013,87.8,2015,83.5,2
1488,2015,83.5,2017,74.6,2
1489,1978,100,2001,74.2,23
1489,2003,75,2005,75,2
1489,2005,75,2007,73.7,2
1489,2007,73.7,2009,73.4,2
1489,2009,73.4,2011,70.1,2
1489,2011,70.1,2013,69.8,2
1489,2013,69.8,2015,64.3,2
1489,2015,64.3,2017,64.3,2
1490,1991,100,2003,75,12
1490,2003,75,2005,75,2
1490,2005,75,2007,75,2
1490,2007,75,2009,75,2
1490,2009,75,2013,75,4
1490,2013,75,2015,75,2
1490,2015,75,2017,74.9,2
1491,2003,67.4,2004,61.5,1
1491,2008,99,2010,98.6,2
1492,2003,22.5,2004,21.3,1
1492,2008,99.6,2010,96.3,2
1492,2010,96.3,2012,95.4,2
1492,2012,95.4,2014,95.1,2
1492,2014,95.1,2016,84.2,2
1493,1961,100,2003,38.3,42
1493,2003,38.3,2004,35.9,1
1493,2006,54.4,2008,53.5,2
1493,2010,54.3,2012,52.1,2
1493,2012,52.1,2014,51.3,2
1494,1992,100,2003,78.1,11
1494,2003,78.1,2004,74.9,1
1494,2004,74.9,2006,71.8,2
1494,2010,75.2,2012,74.9,2
1494,2014,77.5,2016,72.6,2
1495,1979,100,2003,73.2,24
1495,2003,73.2,2004,70.8,1
1495,2006,71.5,2008,71.5,2
1495,2008,71.5,2010,71.1,2
1495,2010,71.1,2012,71.1,2
1495,2012,71.1,2014,69.9,2
1495,2014,69.9,2016,69.1,2
1496,1999,100,2001,83.3,2
1496,2003,98.3,2005,96.4,2
1496,2008,98.3,2010,97.2,2
1496,2010,97.2,2012,95,2
1496,2012,95,2014,94.4,2
1496,2014,94.4,2016,80.1,2
1497,1989,100,2003,93.3,14
1497,2003,93.3,2004,92.9,1
1497,2004,92.9,2006,90.3,2
1497,2006,90.3,2008,89.8,2
1497,2008,89.8,2010,89.6,2
1497,2010,89.6,2012,85.6,2
1497,2012,85.6,2014,81.2,2
1497,2014,81.2,2016,73.9,2
1498,2008,99.7,2010,98.7,2
1498,2010,98.7,2012,98.5,2
1498,2012,98.5,2014,98.4,2
1498,2014,98.4,2016,96.6,2
1499,1960,100,2014,73.8,54
1499,2014,73.8,2016,73.8,2
1500,1981,100,2003,98.4,22
1500,2003,98.4,2004,94,1
1500,2004,94,2006,77.2,2
1500,2006,77.2,2008,67.8,2
1500,2008,67.8,2010,44.4,2
1500,2012,67.3,2014,67.2,2
1500,2014,67.2,2016,66.3,2
1501,2003,72.4,2005,72.3,2
1501,2005,72.3,2007,56.5,2
1501,2007,56.5,2008,56.5,1
1501,2008,56.5,2010,56.3,2
1501,2010,56.3,2012,54.8,2
1501,2014,99.7,2016,96,2
1502,1994,100,2003,65,9
1502,2003,65,2004,65,1
1502,2006,85.2,2008,78.4,2
1502,2008,78.4,2010,76.8,2
1502,2010,76.8,2012,71.9,2
1502,2012,71.9,2014,70.7,2
1503,1988,100,2003,90.5,15
1503,2003,90.5,2004,90.5,1
1503,2004,90.5,2006,87.3,2
1503,2006,87.3,2008,87.1,2
1503,2008,87.1,2010,84.2,2
1503,2010,84.2,2012,80.2,2
1503,2012,80.2,2014,80.2,2
1503,2014,80.2,2016,79.2,2
1504,1987,100,2003,96.2,16
1504,2003,96.2,2004,96,1
1504,2004,96,2006,94.9,2
1504,2006,94.9,2008,92.8,2
1504,2008,92.8,2010,92.7,2
1504,2010,92.7,2012,89,2
1504,2012,89,2014,74.2,2
1504,2014,74.2,2016,74.1,2
1505,1957,100,2003,72.1,46
1505,2003,72.1,2005,72.1,2
1505,2005,72.1,2007,70.2,2
1505,2007,70.2,2008,69.8,1
1505,2008,69.8,2010,69.6,2
1505,2012,72.5,2014,71.5,2
1505,2014,71.5,2016,71.2,2
1506,1966,100,2003,72.6,37
1506,2003,72.6,2005,65.7,2
1506,2008,67.5,2010,67.3,2
1506,2010,67.3,2012,66.2,2
1506,2012,66.2,2014,66.2,2
1506,2014,66.2,2016,65.1,2
1507,2003,74.6,2005,72.2,2
1507,2007,74.7,2008,74.4,1
1507,2008,74.4,2010,73.2,2
1507,2010,73.2,2012,73.2,2
1507,2014,99.6,2016,95.1,2
1508,1970,100,2003,74.6,33
1508,2003,74.6,2005,74.6,2
1508,2005,74.6,2007,62.9,2
1508,2008,69.2,2010,68.7,2
1508,2010,68.7,2014,67.9,4
1508,2014,67.9,2016,67.6,2
1509,1966,100,2003,75,37
1509,2003,75,2004,75,1
1509,2004,75,2006,73.2,2
1509,2006,73.2,2008,73.1,2
1509,2008,73.1,2010,73,2
1509,2012,73.6,2014,72.1,2
1510,1968,100,2001,70.2,33
1510,2003,71.2,2005,71.2,2
1510,2007,71.8,2009,70.8,2
1510,2009,70.8,2011,70.8,2
1510,2013,93.4,2015,92.7,2
1510,2015,92.7,2017,87.2,2
1511,1965,100,2000,65.6,35
1511,2000,65.6,2004,61.3,4
1511,2006,65.8,2007,64.2,1
1511,2009,64.4,2011,62.1,2
1511,2011,62.1,2013,60.6,2
1511,2013,60.6,2015,60.3,2
1512,2003,57,2005,51.8,2
1512,2007,53.8,2009,52,2
1512,2009,52,2011,52,2
1512,2013,99.3,2015,98.2,2
1512,2015,98.2,2017,91.4,2
1513,2003,74.4,2005,74.2,2
1513,2005,74.2,2007,68.7,2
1513,2007,68.7,2009,65.6,2
1513,2009,65.6,2011,65,2
1513,2013,99.9,2017,94.7,4
1514,2003,62.7,2004,55.3,1
1514,2010,74.1,2012,73.9,2
1514,2012,73.9,2014,73.5,2
1514,2014,73.5,2016,73.5,2
1515,1980,100,2003,60.8,23
1515,2008,69,2010,68.9,2
1515,2010,68.9,2012,67.8,2
1515,2014,76.1,2016,73.4,2
1516,1977,100,2003,63.8,26
1516,2003,63.8,2004,59.7,1
1516,2010,70.3,2012,69.5,2
1516,2012,69.5,2014,67.9,2
1516,2014,67.9,2016,67.2,2
1517,1977,100,2003,56.3,26
1517,2003,56.3,2004,53.2,1
1517,2006,68.4,2008,68,2
1517,2008,68,2010,66.6,2
1517,2010,66.6,2012,66.5,2
1517,2012,66.5,2014,64.9,2
1517,2014,64.9,2016,64.5,2
1518,1977,100,2003,72.9,26
1518,2006,73.5,2008,73.1,2
1518,2008,73.1,2010,72.7,2
1518,2010,72.7,2012,72.5,2
1518,2012,72.5,2014,71.6,2
1518,2014,71.6,2016,70.9,2
1519,1980,100,2003,66.3,23
1519,2006,72.4,2008,72.4,2
1519,2008,72.4,2010,71.6,2
1519,2010,71.6,2012,71.3,2
1519,2012,71.3,2014,71,2
1519,2014,71,2016,70,2
1520,1980,100,2003,72.7,23
1520,2003,72.7,2004,72.4,1
1520,2006,73.3,2008,73.3,2
1520,2008,73.3,2010,72.8,2
1520,2010,72.8,2012,72.3,2
1520,2012,72.3,2014,72.2,2
1520,2014,72.2,2016,71.8,2
1521,1980,100,2003,74.4,23
1521,2004,74.5,2006,73.7,2
1521,2006,73.7,2008,73.7,2
1521,2008,73.7,2010,73.4,2
1521,2010,73.4,2012,73.3,2
1521,2012,73.3,2014,73.3,2
1521,2014,73.3,2016,73.2,2
1522,1980,100,2003,73.4,23
1522,2004,74.9,2006,74.8,2
1522,2006,74.8,2008,74.7,2
1522,2008,74.7,2010,74.6,2
1522,2010,74.6,2014,74.5,4
1522,2014,74.5,2016,74.5,2
1523,1980,100,2003,66.2,23
1523,2006,72.9,2008,72.1,2
1523,2008,72.1,2010,71.8,2
1523,2010,71.8,2012,71.2,2
1523,2012,71.2,2014,70.5,2
1523,2014,70.5,2016,70.3,2
1524,1993,100,2003,94.7,10
1524,2003,94.7,2004,88.1,1
1524,2006,97,2008,94.6,2
1524,2008,94.6,2010,93.1,2
1524,2010,93.1,2012,89.9,2
1524,2012,89.9,2014,89.8,2
1524,2014,89.8,2016,81.9,2
1525,1993,100,2003,96.1,10
1525,2003,96.1,2004,95.7,1
1525,2006,97.3,2008,96.4,2
1525,2008,96.4,2010,94.1,2
1525,2010,94.1,2012,89.2,2
1525,2012,89.2,2014,89,2
1525,2014,89,2016,82,2
1526,1985,100,2003,72.9,18
1526,2003,72.9,2004,72.8,1
1526,2006,73.1,2008,73.1,2
1526,2008,73.1,2010,73.1,2
1526,2012,75.3,2014,74.3,2
1526,2014,74.3,2016,73.1,2
1527,1985,100,2003,71.9,18
1527,2003,71.9,2004,71.7,1
1527,2006,84.1,2008,83.1,2
1527,2008,83.1,2010,80.9,2
1527,2010,80.9,2012,78.3,2
1527,2012,78.3,2014,77.8,2
1527,2014,77.8,2016,76.2,2
1528,1984,100,2003,70.2,19
1528,2003,70.2,2004,70.2,1
1528,2008,79.2,2010,79.2,2
1528,2010,79.2,2012,78.1,2
1528,2012,78.1,2014,77.7,2
1528,2014,77.7,2016,75.1,2
1529,1973,100,2003,49.2,30
1529,2006,74.9,2008,74.9,2
1529,2008,74.9,2010,74.3,2
1529,2010,74.3,2012,73.8,2
1529,2012,73.8,2014,73.4,2
1529,2014,73.4,2016,73.4,2
1530,2006,75,2007,67.1,1
1530,2007,67.1,2009,53,2
1530,2009,53,2011,51.5,2
1530,2013,97.1,2017,69.1,4
1531,1975,100,2006,71.4,31
1531,2007,71.5,2009,57.1,2
1531,2009,57.1,2011,56.5,2
1531,2011,56.5,2013,55,2
1531,2013,55,2015,51,2
1531,2015,51,2017,51,2
1532,2000,100,2004,71.5,4
1532,2006,98.2,2007,89,1
1532,2007,89,2009,87.8,2
1532,2009,87.8,2011,87.7,2
1533,1987,100,2004,66.6,17
1533,2007,74.8,2009,63.5,2
1533,2011,71.4,2013,71.2,2
1533,2013,71.2,2015,71,2
1533,2015,71,2017,70.4,2
1534,1981,100,2004,53.9,23
1534,2006,69.5,2007,68.7,1
1534,2007,68.7,2009,59.5,2
1534,2009,59.5,2011,55.5,2
1534,2011,55.5,2013,55.4,2
1534,2013,55.4,2015,54.8,2
1535,1981,100,2004,50.2,23
1535,2006,75,2007,75,1
1535,2007,75,2009,73.7,2
1535,2011,74.2,2015,74.2,4
1535,2015,74.2,2017,70.6,2
1536,1994,100,2003,95.3,9
1536,2003,95.3,2004,94.2,1
1536,2006,96.8,2008,92.4,2
1536,2008,92.4,2010,90.8,2
1536,2012,91.5,2014,91,2
1536,2014,91,2016,87.6,2
1537,2003,73.6,2004,69.5,1
1537,2006,69.9,2008,52.8,2
1537,2008,52.8,2010,52,2
1537,2010,52,2012,49.6,2
1537,2014,96.7,2016,94.8,2
1538,1995,100,2003,100,8
1538,2003,100,2005,99.7,2
1538,2005,99.7,2007,99.6,2
1538,2007,99.6,2008,99.2,1
1538,2008,99.2,2010,98.6,2
1538,2010,98.6,2014,98.5,4
1539,2005,73.8,2007,68.8,2
1539,2007,68.8,2008,67.5,1
1539,2012,92.3,2016,92.1,4
1540,2003,40,2004,2.7,1
1540,2006,68.6,2008,68,2
1540,2008,68,2010,65.6,2
1540,2012,96.1,2016,92.4,4
1541,1948,100,2003,63.5,55
1541,2004,70.5,2006,68.5,2
1541,2006,68.5,2008,67.1,2
1541,2008,67.1,2010,66.8,2
1541,2012,73,2014,69.8,2
1541,2014,69.8,2016,68.1,2
1542,2004,98.9,2006,98.8,2
1542,2006,98.8,2008,98.7,2
1542,2008,98.7,2010,97.7,2
1543,2003,65.1,2004,65.1,1
1543,2006,74.8,2008,3.6,2
1543,2010,5,2012,1.6,2
1543,2014,99.4,2016,97.3,2
1544,2003,75,2004,75,1
1544,2004,75,2006,74.6,2
1544,2006,74.6,2008,27.9,2
1544,2014,99.8,2016,99.2,2
1545,2003,68.5,2004,68.5,1
1545,2004,68.5,2006,56,2
1545,2006,56,2008,33.3,2
1545,2008,33.3,2010,33.3,2
1545,2010,33.3,2012,2,2
1545,2014,99.6,2016,98.9,2
1546,2003,100,2004,97.5,1
1546,2006,99.1,2008,96.4,2
1546,2008,96.4,2010,94.4,2
1546,2010,94.4,2014,91.8,4
1547,1946,100,2003,73.4,57
1547,2003,73.4,2004,72.9,1
1547,2004,72.9,2006,66.7,2
1547,2006,66.7,2008,66.7,2
1547,2008,66.7,2010,63.6,2
1547,2010,63.6,2012,63.4,2
1547,2014,65,2016,63.4,2
1548,1994,100,2003,75,9
1548,2003,75,2004,74.5,1
1548,2004,74.5,2006,74.4,2
1548,2008,74.8,2010,74.7,2
1548,2014,75,2016,74.9,2
1549,1990,100,2003,73.5,13
1549,2003,73.5,2004,73.5,1
1549,2006,74,2008,72.9,2
1549,2008,72.9,2010,72.3,2
1549,2010,72.3,2014,70.9,4
1549,2014,70.9,2016,70.2,2
1550,1969,100,2003,72.1,34
1550,2008,77.9,2010,74.5,2
1550,2010,74.5,2014,74.5,4
1551,1980,100,2003,58.9,23
1551,2003,58.9,2004,58.9,1
1551,2004,58.9,2006,54.1,2
1551,2006,54.1,2008,46.6,2
1551,2008,46.6,2010,46.4,2
1551,2010,46.4,2012,43.1,2
1551,2012,43.1,2014,40.6,2
1552,1984,100,2003,75,19
1552,2003,75,2004,75,1
1552,2006,94.3,2008,74.8,2
1552,2008,74.8,2010,73.8,2
1552,2010,73.8,2014,72.7,4
1552,2014,72.7,2016,69.9,2
1553,2003,51.9,2004,51.3,1
1553,2004,51.3,2006,41.9,2
1553,2008,42.4,2010,38.4,2
1553,2010,38.4,2012,34.8,2
1553,2014,99.8,2016,97.4,2
1554,2003,49.3,2004,49.3,1
1554,2004,49.3,2006,10.1,2
1554,2008,10.8,2010,9.9,2
1554,2010,9.9,2012,6.1,2
1554,2014,99.1,2016,97.4,2
1555,2004,69.6,2006,68.7,2
1555,2006,68.7,2008,67.9,2
1555,2012,99.7,2016,91.2,4
1556,2007,99.9,2009,99.8,2
1556,2009,99.8,2013,98.9,4
1556,2013,98.9,2017,89.3,4
1557,1958,100,2003,64.5,45
1557,2003,64.5,2004,64.5,1
1557,2008,75.4,2010,75,2
1557,2010,75,2014,74.9,4
1557,2014,74.9,2016,74.9,2
1558,1948,100,2003,70.1,55
1558,2005,71.9,2007,62.4,2
1558,2007,62.4,2008,61.5,1
1558,2012,74,2014,73.6,2
1558,2014,73.6,2016,72.6,2
1559,1930,100,2003,75.4,73
1559,2003,75.4,2004,73.6,1
1559,2006,75,2008,72.6,2
1559,2008,72.6,2010,72.6,2
1559,2010,72.6,2014,71.7,4
1560,1955,100,2003,41.8,48
1560,2003,41.8,2004,3.8,1
1560,2006,73.5,2008,73.5,2
1560,2008,73.5,2010,71.6,2
1560,2014,71.8,2016,71.8,2
1561,2009,100,2012,98.9,3
1561,2012,98.9,2014,98.3,2
1561,2014,98.3,2016,90.8,2
1562,2009,100,2012,99.2,3
1562,2012,99.2,2014,98.8,2
1562,2014,98.8,2016,91.5,2
1563,2009,100,2012,99.1,3
1563,2012,99.1,2014,97.8,2
1563,2014,97.8,2016,91.3,2
1564,2008,100,2012,98.8,4
1564,2012,98.8,2014,98.6,2
1564,2014,98.6,2016,96.4,2
1565,2008,100,2012,98.8,4
1565,2012,98.8,2014,98.6,2
1565,2014,98.6,2016,90.1,2
1566,2010,100,2012,98.9,2
1566,2012,98.9,2014,96.4,2
1566,2014,96.4,2016,93.3,2
1567,2010,100,2012,99.2,2
1567,2012,99.2,2014,97.9,2
1567,2014,97.9,2016,95.7,2
1568,2010,100,2012,99,2
1568,2012,99,2014,98.2,2
1568,2014,98.2,2016,91.9,2
1569,2010,100,2012,98.6,2
1569,2012,98.6,2014,97.9,2
1569,2014,97.9,2016,91.5,2
1570,2008,100,2012,98.6,4
1570,2012,98.6,2014,98,2
1570,2014,98,2016,96,2
1571,2009,100,2012,99.1,3
1571,2012,99.1,2014,98.9,2
1571,2014,98.9,2016,91.3,2
1572,2006,100,2010,99.4,4
1572,2010,99.4,2012,97.1,2
1572,2012,97.1,2014,96.8,2
1572,2014,96.8,2016,86.5,2
1573,2006,100,2010,99.4,4
1573,2010,99.4,2012,98.8,2
1573,2012,98.8,2014,98.5,2
1573,2014,98.5,2016,87.2,2
1574,2007,100,2012,98.5,5
1574,2012,98.5,2014,98.3,2
1574,2014,98.3,2016,88.5,2
1575,2009,100,2012,97.5,3
1575,2012,97.5,2014,96.7,2
1575,2014,96.7,2016,86.6,2
1576,2009,100,2012,97.4,3
1576,2012,97.4,2014,96.3,2
1576,2014,96.3,2016,86.4,2
1577,2009,100,2010,100,1
1577,2010,100,2012,98.7,2
1577,2012,98.7,2014,98,2
1577,2014,98,2016,90.3,2
1578,2008,100,2010,99,2
1578,2010,99,2012,98.7,2
1578,2014,99.2,2016,91,2
1579,2010,100,2012,99.3,2
1579,2012,99.3,2014,98.5,2
1579,2014,98.5,2016,91.7,2
1580,2008,100,2010,98.9,2
1580,2010,98.9,2012,98.5,2
1580,2014,98.8,2016,92.1,2
1581,2010,100,2012,99.1,2
1581,2012,99.1,2014,98.8,2
1581,2014,98.8,2016,91.8,2
1582,2009,100,2012,97.8,3
1582,2012,97.8,2014,97.5,2
1582,2014,97.5,2016,88.4,2
1583,1993,100,2006,74.1,13
1583,2010,77.2,2014,76.5,4
1583,2014,76.5,2016,74.2,2
1584,2008,100,2012,98.4,4
1584,2012,98.4,2016,91.8,4
1585,2010,100,2012,99.7,2
1585,2012,99.7,2014,99.5,2
1585,2014,99.5,2016,91.7,2
1586,2010,100,2012,99.9,2
1586,2012,99.9,2014,99.8,2
1586,2014,99.8,2016,93.3,2
1587,2010,100,2012,98.8,2
1587,2012,98.8,2016,93.6,4
1588,2010,100,2012,99.1,2
1588,2012,99.1,2016,91.7,4
1589,2012,100,2016,94.9,4
1590,2012,100,2016,94.9,4
1591,2010,100,2012,99,2
1591,2012,99,2016,92.4,4
1592,2010,100,2012,98.7,2
1592,2012,98.7,2016,92,4
1593,2010,100,2012,98,2
1593,2012,98,2016,95,4
1594,2010,100,2012,97.3,2
1594,2012,97.3,2016,91.2,4
1595,2010,100,2012,98.6,2
1595,2012,98.6,2016,92.1,4
1596,2010,100,2012,99.2,2
1596,2012,99.2,2016,92.2,4
1597,2012,99.8,2014,94.8,2
1597,2014,94.8,2016,86.2,2
1598,2012,99.9,2014,95,2
1598,2014,95,2016,88.8,2
1599,2009,7.1,2011,4.5,2
1599,2013,99.4,2017,92.5,4
1600,2009,100,2011,98.4,2
1601,1984,100,2011,67.9,27
1601,2011,67.9,2013,67.5,2
1601,2013,67.5,2015,65.2,2
1602,2013,100,2014,99.4,1
1602,2014,99.4,2016,97.9,2
1603,2001,75,2003,72.2,2
1603,2003,72.2,2005,72.2,2
1603,2007,73.7,2009,73.7,2
1603,2009,73.7,2011,73.3,2
1603,2011,73.3,2013,73.3,2
1604,2001,75.2,2003,56.6,2
1604,2003,56.6,2005,56.5,2
1604,2007,66.3,2009,66.3,2
1604,2011,98.9,2013,98,2
1604,2013,98,2015,96.6,2
1604,2015,96.6,2017,88.7,2
1605,1950,100,2003,73.5,53
1605,2003,73.5,2005,73.5,2
1605,2005,73.5,2007,73.1,2
1605,2007,73.1,2009,72.9,2
1605,2009,72.9,2011,71.3,2
1605,2013,74.2,2015,74.2,2
1605,2015,74.2,2017,73.5,2
1606,2003,47.7,2005,47.3,2
1606,2009,99.8,2011,98.6,2
1606,2011,98.6,2013,97.9,2
1606,2013,97.9,2015,97.9,2
1606,2015,97.9,2017,76.4,2
1607,1972,100,2001,73.2,29
1607,2007,74.5,2009,72.5,2
1607,2009,72.5,2011,72.5,2
1607,2013,72.6,2015,72.5,2
1607,2015,72.5,2017,72.2,2
1608,2003,59.9,2005,59.6,2
1608,2007,100,2009,99.8,2
1608,2009,99.8,2011,98.1,2
1608,2011,98.1,2013,97.5,2
1608,2013,97.5,2015,97.4,2
1608,2015,97.4,2017,88.9,2
1609,1998,100,2003,73.7,5
1609,2005,73.8,2007,72.2,2
1609,2009,73.1,2013,71.8,4
1609,2013,71.8,2015,71.5,2
1610,1986,100,2001,71.9,15
1610,2003,73,2005,72.3,2
1610,2005,72.3,2007,71.8,2
1610,2011,73.6,2013,73.3,2
1610,2013,73.3,2015,73.2,2
1610,2015,73.2,2017,72.3,2
1611,1954,100,2003,57.9,49
1611,2003,57.9,2005,57.9,2
1611,2007,66.7,2009,65.3,2
1611,2011,67.7,2013,66.8,2
1611,2013,66.8,2015,65.6,2
1611,2015,65.6,2017,64.8,2
1612,1987,100,2001,94.4,14
1612,2001,94.4,2003,74.4,2
1612,2009,78.2,2011,76.6,2
1612,2011,76.6,2013,73.8,2
1612,2013,73.8,2015,73,2
1613,2005,57.9,2007,47,2
1613,2009,99.9,2011,98.4,2
1613,2011,98.4,2013,97.3,2
1613,2013,97.3,2015,97.3,2
1613,2015,97.3,2017,87.5,2
1614,1993,100,2001,89.7,8
1614,2001,89.7,2003,74.6,2
1614,2003,74.6,2005,74.6,2
1614,2011,84.1,2013,84.1,2
1614,2013,84.1,2015,84,2
1614,2015,84,2017,76.2,2
1615,1992,100,2001,82,9
1615,2001,82,2003,73.9,2
1615,2003,73.9,2005,73.7,2
1615,2009,75.1,2011,74.8,2
1615,2011,74.8,2013,74.4,2
1615,2013,74.4,2015,73.8,2
1616,1997,100,2001,79.3,4
1616,2001,79.3,2003,74.7,2
1616,2003,74.7,2005,74.7,2
1616,2007,83.5,2009,83.4,2
1616,2013,92.7,2015,92.6,2
1616,2015,92.6,2017,88.4,2
1617,1991,100,2001,73.2,10
1617,2003,74.8,2005,74.8,2
1617,2005,74.8,2007,74.8,2
1617,2009,85.8,2011,85.7,2
1617,2011,85.7,2013,81.5,2
1617,2013,81.5,2015,76.2,2
1617,2015,76.2,2017,73.7,2
1618,1998,100,2001,89.8,3
1618,2003,93.8,2005,93.7,2
1618,2007,94.3,2009,94.2,2
1618,2009,94.2,2011,92.3,2
1618,2011,92.3,2013,91,2
1618,2013,91,2015,90.7,2
1618,2015,90.7,2017,90,2
1619,1956,100,2003,71.5,47
1619,2009,75.7,2013,73.7,4
1619,2013,73.7,2015,72,2
1619,2015,72,2017,71.4,2
1620,1970,100,2003,74.5,33
1620,2003,74.5,2005,74.4,2
1620,2005,74.4,2007,72.9,2
1620,2007,72.9,2009,71.3,2
1620,2009,71.3,2011,70.7,2
1620,2011,70.7,2013,70.6,2
1620,2013,70.6,2015,70.2,2
1620,2015,70.2,2017,70.1,2
1621,1961,100,2004,59.1,43
1621,2004,59.1,2005,58.1,1
1621,2005,58.1,2009,53,4
1621,2009,53,2011,50.5,2
1621,2011,50.5,2013,48.3,2
1621,2013,48.3,2015,47.8,2
1621,2015,47.8,2017,44.9,2
1622,1938,100,2003,73.2,65
1622,2003,73.2,2005,71.8,2
1622,2005,71.8,2007,70.5,2
1622,2007,70.5,2009,70.2,2
1622,2011,71.2,2013,70.2,2
1622,2013,70.2,2015,69.4,2
1622,2015,69.4,2017,64.8,2
1623,1938,100,2003,75,65
1623,2003,75,2005,74.3,2
1623,2005,74.3,2007,72.5,2
1623,2009,73.8,2013,71.8,4
1623,2013,71.8,2015,71,2
1623,2015,71,2017,69.3,2
1624,1960,100,2003,69.3,43
1624,2003,69.3,2005,69.3,2
1624,2005,69.3,2007,67.2,2
1624,2009,71.1,2013,61.5,4
1624,2013,61.5,2015,60.7,2
1624,2015,60.7,2017,60,2
1625,2003,22.1,2005,2.6,2
1625,2005,2.6,2007,2.1,2
1625,2009,6.8,2011,6.8,2
1625,2011,6.8,2013,6.8,2
1626,2007,75,2009,69.3,2
1627,1970,100,2003,73.9,33
1627,2003,73.9,2005,73.9,2
1627,2005,73.9,2007,70,2
1627,2009,76,2013,72.4,4
1627,2013,72.4,2015,72.4,2
1628,1970,100,2003,75,33
1628,2003,75,2005,75,2
1628,2005,75,2007,75,2
1628,2007,75,2009,75,2
1628,2009,75,2011,74.6,2
1628,2011,74.6,2015,74.4,4
1629,1970,100,2003,74.7,33
1629,2005,74.8,2007,74.2,2
1629,2007,74.2,2009,70.3,2
1629,2011,72.6,2015,71.6,4
1629,2015,71.6,2017,71.2,2
1630,1970,100,2003,75,33
1630,2003,75,2005,75,2
1630,2005,75,2007,75,2
1630,2007,75,2009,75,2
1630,2009,75,2013,74.4,4
1630,2013,74.4,2015,74.3,2
1630,2015,74.3,2017,74.2,2
1631,2006,100,2007,95.9,1
1631,2009,98.4,2013,96.8,4
1631,2013,96.8,2017,87.7,4
1632,2003,41.4,2005,41.1,2
1632,2007,99.6,2009,94.7,2
1632,2009,94.7,2013,94.7,4
1632,2013,94.7,2017,87.8,4
1633,1997,100,2003,75,6
1633,2003,75,2005,75,2
1633,2005,75,2007,74.8,2
1634,1997,100,2003,74.9,6
1634,2003,74.9,2005,74.9,2
1634,2005,74.9,2007,74.8,2
1634,2007,74.8,2009,72.8,2
1634,2011,78.1,2015,77.1,4
1634,2015,77.1,2017,74.8,2
1635,1984,100,2003,75,19
1635,2003,75,2005,75,2
1635,2005,75,2007,74.8,2
1635,2009,75.1,2013,72.8,4
1635,2013,72.8,2015,72.2,2
1635,2015,72.2,2017,70.8,2
1636,1960,100,2007,72.7,47
1636,2007,72.7,2009,72.2,2
1636,2009,72.2,2013,71.6,4
1636,2013,71.6,2015,71,2
1636,2015,71,2017,70.8,2
1638,1939,100,2001,47.1,62
1638,2001,47.1,2003,47.1,2
1638,2003,47.1,2005,47.1,2
1638,2009,50.3,2011,48.6,2
1638,2011,48.6,2013,45.3,2
1638,2013,45.3,2015,39.5,2
1638,2015,39.5,2017,39.5,2
1639,2001,49.4,2003,34.9,2
1639,2005,47.5,2006,45.7,1
1639,2006,45.7,2007,45.2,1
1639,2007,45.2,2008,41.7,1
1639,2008,41.7,2009,40.8,1
1639,2009,40.8,2010,40.2,1
1639,2013,100,2015,97.7,2
1639,2015,97.7,2017,87,2
1640,2003,55.3,2005,53.5,2
1640,2006,61.7,2007,59.7,1
1640,2007,59.7,2008,58.8,1
1640,2009,99,2010,98.4,1
1640,2010,98.4,2012,93.6,2
1640,2012,93.6,2014,92.1,2
1640,2014,92.1,2016,90.9,2
1641,1985,100,2001,71.7,16
1641,2001,71.7,2003,71.6,2
1641,2010,73.5,2012,73.2,2
1641,2014,73.5,2016,73.5,2
1642,1981,100,2001,65.8,20
1642,2001,65.8,2004,63.8,3
1642,2004,63.8,2006,59.7,2
1642,2006,59.7,2010,59.7,4
1642,2014,72.6,2016,72.2,2
1643,1952,100,2001,47,49
1643,2001,47,2003,45.5,2
1643,2003,45.5,2005,43.6,2
1643,2005,43.6,2007,43.3,2
1643,2007,43.3,2009,42.2,2
1643,2009,42.2,2011,42.1,2
1643,2011,42.1,2013,42.1,2
1644,2001,52.1,2003,40.8,2
1644,2005,44.1,2006,44,1
1644,2006,44,2008,39.4,2
1644,2008,39.4,2010,38.9,2
1644,2014,92.8,2016,85.6,2
1645,1938,100,2001,50.9,63
1645,2001,50.9,2005,46.2,4
1645,2009,67.5,2011,67.3,2
1645,2015,69.5,2017,67.5,2
1646,2000,100,2001,73.4,1
1646,2003,74.2,2005,74,2
1646,2005,74,2006,73,1
1646,2010,79.9,2012,77,2
1646,2014,77.6,2016,73.9,2
1647,1964,100,2005,49.8,41
1647,2009,62.6,2013,62.1,4
1647,2015,67.6,2017,67.6,2
1648,1969,100,2003,73.6,34
1648,2003,73.6,2005,68.4,2
1648,2005,68.4,2006,68,1
1648,2008,68.3,2010,67.7,2
1648,2014,71.8,2016,70.5,2
1649,1968,100,2003,61.2,35
1649,2005,70.6,2006,69.9,1
1649,2008,73.3,2009,73,1
1649,2009,73,2010,72.8,1
1649,2010,72.8,2011,71.3,1
1649,2011,71.3,2012,71.1,1
1649,2012,71.1,2013,70,1
1649,2014,72,2015,71.6,1
1649,2015,71.6,2016,71.4,1
1649,2016,71.4,2017,71.3,1
1650,1974,100,2001,74.8,27
1650,2001,74.8,2005,62.4,4
1650,2009,66.5,2013,65.8,4
1650,2015,72.7,2017,68.9,2
1651,1965,100,2003,55.4,38
1651,2003,55.4,2005,48.1,2
1651,2009,52.8,2011,52.4,2
1651,2013,53.9,2015,52.6,2
1651,2015,52.6,2017,52.6,2
1652,1899,100,2001,57.7,102
1652,2004,60.4,2006,58,2
1652,2010,66.2,2014,56.5,4
1653,1966,100,2001,68.9,35
1653,2001,68.9,2004,59.4,3
1653,2004,59.4,2006,59.4,2
1653,2010,62.2,2014,59.8,4
1653,2014,59.8,2016,59.4,2
1654,1899,100,2001,17.4,102
1654,2006,55.4,2010,48.5,4
1655,1899,100,2001,61.9,102
1655,2001,61.9,2004,55.4,3
1655,2004,55.4,2006,52.7,2
1655,2014,68.6,2016,68.4,2
1656,1899,100,2001,67.4,102
1656,2001,67.4,2004,67.1,3
1656,2004,67.1,2006,58.2,2
1656,2014,69.1,2016,68.8,2
1657,1899,100,2001,42.4,102
1657,2001,42.4,2004,41.9,3
1657,2004,41.9,2006,33.9,2
1657,2014,63.5,2016,59.7,2
1658,1899,100,2001,51.1,102
1658,2001,51.1,2004,37.9,3
1658,2006,38.3,2010,37.6,4
1658,2010,37.6,2014,32.7,4
1658,2014,32.7,2016,29.8,2
1659,1899,100,2001,40.6,102
1659,2004,50.3,2006,50.3,2
1659,2014,61.7,2016,61.3,2
1660,2001,35.6,2004,22.1,3
1660,2004,22.1,2005,16.9,1
1660,2005,16.9,2006,15.8,1
1660,2006,15.8,2007,10.2,1
1660,2007,10.2,2008,1.3,1
1660,2008,1.3,2009,1.3,1
1660,2009,1.3,2010,1.2,1
1660,2013,100,2015,99.1,2
1660,2015,99.1,2017,90.3,2
1661,1899,100,2001,35,102
1661,2004,49,2006,48.6,2
1661,2014,60,2016,59.9,2
1662,1899,100,2001,41.2,102
1662,2004,44.5,2006,38.3,2
1662,2008,38.6,2010,20.6,2
1662,2014,22.3,2016,22.3,2
1663,1899,100,2001,48.8,102
1663,2001,48.8,2004,47.8,3
1663,2004,47.8,2006,44.4,2
1663,2010,54.2,2014,54,4
1664,2001,26.8,2004,22.6,3
1664,2004,22.6,2006,19.1,2
1664,2008,22.5,2010,22.3,2
1664,2010,22.3,2012,21.6,2
1664,2012,21.6,2013,19.9,1
1664,2013,19.9,2014,15.5,1
1665,1899,100,2001,64.7,102
1665,2001,64.7,2004,49.6,3
1665,2004,49.6,2006,47.7,2
1666,1976,100,2001,67.1,25
1666,2001,67.1,2005,64.4,4
1666,2009,71.4,2013,70.9,4
1666,2013,70.9,2017,70.2,4
1667,1976,100,2005,50.7,29
1667,2009,66.3,2013,66,4
1668,1899,100,2001,39.9,102
1668,2001,39.9,2005,33.1,4
1668,2009,57.1,2011,56.7,2
1668,2011,56.7,2013,55.4,2
1668,2013,55.4,2015,51.2,2
1668,2015,51.2,2017,46.2,2
1669,1899,100,2001,72.9,102
1669,2001,72.9,2005,50.7,4
1669,2013,67.5,2015,67.5,2
1669,2015,67.5,2017,67.1,2
1670,1899,100,2001,68,102
1670,2001,68,2005,58.8,4
1670,2005,58.8,2007,58.8,2
1670,2007,58.8,2009,57.3,2
1670,2011,57.7,2013,56.2,2
1670,2013,56.2,2015,26.7,2
1671,1899,100,2001,29.2,102
1671,2007,46.5,2009,45.2,2
1671,2011,53.3,2013,50.4,2
1671,2013,50.4,2015,44.6,2
1672,1984,100,2001,68.4,17
1672,2001,68.4,2005,67.6,4
1672,2005,67.6,2009,67.3,4
1672,2009,67.3,2013,66.5,4
1672,2013,66.5,2015,66.5,2
1673,1899,100,2001,75,102
1673,2001,75,2005,57,4
1673,2009,61.6,2013,61.3,4
1673,2013,61.3,2015,60.5,2
1673,2015,60.5,2017,58.6,2
1674,1899,100,2001,59.2,102
1674,2001,59.2,2004,55.2,3
1674,2004,55.2,2006,55.2,2
1674,2010,63.3,2014,61.2,4
1675,1981,100,2001,67.1,20
1675,2001,67.1,2004,64.9,3
1675,2004,64.9,2006,64.9,2
1676,1899,100,2001,74.6,102
1676,2001,74.6,2005,62.1,4
1676,2005,62.1,2007,61,2
1676,2007,61,2009,50.6,2
1676,2011,61.8,2013,61,2
1676,2015,65.4,2017,62.5,2
1677,1899,100,2001,60.4,102
1677,2001,60.4,2004,47,3
1677,2004,47,2006,46.4,2
1677,2010,58,2014,57.9,4
1678,1899,100,2001,40,102
1678,2007,67.5,2009,65.7,2
1678,2009,65.7,2011,65.5,2
1678,2011,65.5,2013,64.6,2
1679,1899,100,2001,61.9,102
1679,2001,61.9,2005,57,4
1679,2015,68.4,2017,67.2,2
1680,2004,100,2005,74.1,1
1680,2005,74.1,2006,73.6,1
1681,1899,100,2005,43.1,106
1682,1938,100,2005,36.1,67
1682,2005,36.1,2006,35.5,1
1682,2006,35.5,2008,34.3,2
1682,2012,34.6,2014,30,2
1682,2014,30,2016,29.5,2
1682,2016,29.5,2017,29.5,1
1683,1967,100,2005,59.3,38
1683,2013,75.1,2017,74.7,4
1684,2014,100,2016,96.6,2
1685,1997,100,2001,74.1,4
1685,2001,74.1,2003,72.7,2
1685,2003,72.7,2005,72.5,2
1685,2005,72.5,2007,71.3,2
1685,2011,76.6,2013,73,2
1685,2013,73,2015,72.2,2
1686,1997,100,2001,74.6,4
1686,2001,74.6,2003,73.4,2
1686,2003,73.4,2005,70.6,2
1686,2005,70.6,2007,67.2,2
1686,2013,79.1,2015,74.7,2
1687,1953,100,2000,68.4,47
1687,2000,68.4,2004,68.4,4
1687,2004,68.4,2005,66,1
1687,2005,66,2007,62.5,2
1687,2007,62.5,2009,61.7,2
1687,2013,62.5,2015,62.5,2
1688,1951,100,2000,60.6,49
1688,2004,62.5,2005,61.5,1
1688,2005,61.5,2006,61.5,1
1688,2012,66.9,2014,65.7,2
1689,1950,100,2000,65,50
1689,2004,65.9,2005,62,1
1689,2005,62,2007,60.1,2
1689,2007,60.1,2009,59.3,2
1689,2011,59.8,2013,59.3,2
1689,2013,59.3,2015,58.6,2
1690,1899,100,2001,53.1,102
1690,2001,53.1,2004,42.2,3
1690,2004,42.2,2006,38.5,2
1690,2006,38.5,2008,33.5,2
1690,2008,33.5,2010,33.1,2
1690,2010,33.1,2012,32.6,2
1690,2014,52.4,2016,45.5,2
1691,2001,50.8,2004,30.9,3
1691,2007,99.7,2011,81,4
1691,2015,84.4,2017,82.5,2
1692,1899,100,2001,66,102
1692,2001,66,2004,52,3
1692,2010,64.6,2014,57.7,4
1692,2014,57.7,2016,57.6,2
1693,1994,100,2001,67.6,7
1693,2004,69.6,2006,69.6,2
1693,2010,73.9,2014,73.9,4
1694,1899,100,2001,38.7,102
1694,2001,38.7,2004,36.3,3
1694,2004,36.3,2006,34.2,2
1694,2008,37.4,2010,32.6,2
1694,2012,34.2,2014,34.2,2
1694,2014,34.2,2016,34.2,2
1695,1899,100,2001,40.1,102
1695,2004,45.8,2006,45,2
1695,2008,51.5,2010,35.2,2
1695,2012,40,2014,39.9,2
1695,2014,39.9,2016,39.9,2
1696,2004,32.7,2006,28.6,2
1696,2008,36.6,2010,32.9,2
1696,2010,32.9,2012,32.9,2
1696,2012,32.9,2014,28.1,2
1697,1899,100,2001,46.6,102
1697,2001,46.6,2004,46.6,3
1697,2004,46.6,2005,46.6,1
1697,2005,46.6,2006,44.3,1
1697,2008,54.9,2010,54.1,2
1697,2010,54.1,2012,53.6,2
1698,1899,100,2001,29.5,102
1698,2004,40.1,2006,39.3,2
1698,2008,51,2010,49.4,2
1698,2010,49.4,2012,47,2
1698,2012,47,2014,46.5,2
1698,2014,46.5,2016,45.9,2
1699,2001,28.3,2004,25.2,3
1699,2004,25.2,2005,24.5,1
1699,2005,24.5,2006,24.5,1
1699,2006,24.5,2007,24.5,1
1699,2009,58.7,2010,45.8,1
1699,2010,45.8,2011,43.4,1
1699,2011,43.4,2012,40.8,1
1699,2012,40.8,2013,39.3,1
1699,2013,39.3,2014,39.3,1
1700,1899,100,2001,24.3,102
1700,2010,49.3,2012,44.8,2
1700,2012,44.8,2014,44.6,2
1700,2014,44.6,2016,44.6,2
1701,1899,100,2002,50.9,103
1701,2004,54.5,2006,53.6,2
1701,2014,71.4,2016,70,2
1702,1899,100,2002,52.7,103
1702,2004,56.2,2006,54.4,2
1702,2014,73.4,2016,71,2
1703,1899,100,2002,46.2,103
1703,2014,64.8,2016,64.8,2
1704,1899,100,2002,28.9,103
1704,2002,28.9,2004,26.8,2
1704,2004,26.8,2006,26.8,2
1704,2014,57.6,2016,57.3,2
1705,1899,100,2002,66.7,103
1705,2010,70.4,2014,69.8,4
1706,1899,100,2002,58.3,103
1706,2002,58.3,2004,55.6,2
1706,2010,68.1,2014,59,4
1706,2014,59,2016,57.4,2
1707,1899,100,2001,40,102
1707,2001,40,2004,39.7,3
1707,2004,39.7,2006,37.2,2
1707,2008,38.3,2010,38.2,2
1707,2012,39,2014,38.7,2
1707,2014,38.7,2016,38.7,2
1708,1899,100,2001,32.1,102
1708,2004,33.2,2006,33.2,2
1708,2010,38,2012,34.7,2
1708,2014,37.4,2016,37.1,2
1709,2002,20.4,2004,15.1,2
1709,2004,15.1,2005,15.1,1
1709,2006,15.3,2007,15.2,1
1709,2008,15.3,2009,15,1
1709,2010,15.3,2011,15.3,1
1709,2012,15.4,2013,15.3,1
1709,2013,15.3,2014,15.3,1
1710,2004,44.5,2006,40.7,2
1710,2006,40.7,2008,20.9,2
1710,2008,20.9,2010,20.3,2
1710,2012,22.5,2014,20.3,2
1711,1899,100,2005,54.9,106
1711,2010,68.6,2014,62.7,4
1711,2014,62.7,2016,58.7,2
1712,1899,100,2005,53,106
1712,2005,53,2006,53,1
1712,2010,68,2014,67.3,4
1712,2014,67.3,2016,66.6,2
1713,1899,100,2005,38.6,106
1713,2005,38.6,2006,38.6,1
1713,2006,38.6,2010,38.1,4
1713,2014,38.4,2016,38.4,2
1714,1899,100,2005,55.7,106
1714,2005,55.7,2006,54.3,1
1714,2010,69,2014,68.7,4
1715,1899,100,2006,44.9,107
1715,2008,68.5,2010,67.3,2
1715,2010,67.3,2012,54.7,2
1715,2012,54.7,2014,54.7,2
1716,1899,100,2005,38.9,106
1716,2005,38.9,2006,34.5,1
1716,2008,34.9,2010,25.9,2
1716,2012,28.8,2014,23.4,2
1716,2014,23.4,2016,16,2
1717,1977,100,2001,45.8,24
1717,2001,45.8,2005,45.8,4
1717,2005,45.8,2009,43,4
1717,2013,43.3,2015,43.3,2
1717,2015,43.3,2017,43.3,2
1718,1899,100,2001,54.2,102
1718,2001,54.2,2005,46.2,4
1718,2009,46.6,2013,46.6,4
1719,1962,100,2001,58.2,39
1719,2001,58.2,2005,56.2,4
1719,2005,56.2,2009,54.5,4
1719,2015,62.9,2017,62.7,2
1720,1960,100,2001,61.4,41
1720,2001,61.4,2005,50.2,4
1720,2005,50.2,2009,48.9,4
1720,2009,48.9,2013,48.9,4
1720,2015,49,2017,49,2
1721,1967,100,2001,51.1,34
1721,2001,51.1,2005,46.6,4
1721,2005,46.6,2009,45,4
1721,2009,45,2013,43.4,4
1721,2015,44.1,2017,44.1,2
1722,2001,68.2,2003,54.3,2
1722,2005,61.2,2006,60.3,1
1722,2008,95.4,2010,94.8,2
1722,2010,94.8,2012,94.7,2
1722,2012,94.7,2014,88,2
1722,2014,88,2016,77.6,2
1723,1962,100,2001,62.3,39
1723,2001,62.3,2005,50,4
1723,2005,50,2006,45.1,1
1723,2008,72.1,2010,71.9,2
1723,2012,72.1,2014,71.3,2
1724,1986,100,2001,41.2,15
1724,2009,59.5,2013,59.4,4
1724,2015,60.6,2017,60.6,2
1725,1977,100,2001,61.2,24
1725,2009,69.2,2013,69,4
1725,2015,70,2017,70,2
1726,1975,100,2001,40.5,26
1726,2007,51.3,2009,47.3,2
1726,2009,47.3,2011,43,2
1726,2011,43,2013,42.5,2
1726,2015,49.4,2017,49.4,2
1727,1969,100,2001,55,32
1727,2009,62.4,2013,61.9,4
1728,1998,100,2001,73.6,3
1728,2003,74.9,2005,72.8,2
1728,2006,74,2008,73.6,2
1728,2008,73.6,2010,73.4,2
1728,2010,73.4,2012,73.3,2
1728,2012,73.3,2014,73.2,2
1729,1975,100,2001,47.1,26
1729,2005,62.7,2006,62.5,1
1729,2008,66,2010,65.6,2
1730,1998,100,2001,67.5,3
1730,2003,73.9,2005,73.9,2
1730,2006,74.4,2008,73.6,2
1730,2008,73.6,2010,73.1,2
1730,2010,73.1,2012,73,2
1730,2012,73,2014,72.6,2
1730,2014,72.6,2016,72.3,2
1731,1976,100,2001,48.8,25
1731,2003,63.1,2005,62.3,2
1731,2005,62.3,2006,62.2,1
1731,2008,63.7,2010,62,2
1731,2012,64.8,2014,64.7,2
1732,1981,100,2001,74,20
1732,2001,74,2005,63.3,4
1732,2009,65.5,2013,65.2,4
1733,1981,100,2001,72.8,20
1733,2001,72.8,2005,70.9,4
1733,2005,70.9,2009,70.4,4
1733,2009,70.4,2013,70.2,4
1734,1975,100,2001,70.8,26
1734,2001,70.8,2005,50.3,4
1734,2009,63.8,2013,63.8,4
1734,2013,63.8,2015,61.6,2
1735,1975,100,2001,71.9,26
1735,2007,73.8,2009,73.7,2
1735,2009,73.7,2011,73.1,2
1735,2011,73.1,2013,72.9,2
1735,2013,72.9,2015,72.8,2
1735,2015,72.8,2017,72.2,2
1736,1975,100,2001,38.9,26
1736,2009,52.9,2013,50.3,4
1736,2013,50.3,2015,50.3,2
1736,2015,50.3,2017,50.3,2
1737,1981,100,2001,66.8,20
1737,2001,66.8,2005,61.5,4
1737,2005,61.5,2009,59.1,4
1737,2009,59.1,2013,58.9,4
1738,1899,100,2001,57.6,102
1738,2001,57.6,2005,41.5,4
1738,2015,60.5,2017,60.5,2
1739,1983,100,2001,59.1,18
1739,2001,59.1,2005,58.9,4
1739,2009,59.6,2013,58.4,4
1739,2013,58.4,2015,57.8,2
1739,2015,57.8,2017,57.8,2
1740,1975,100,2001,67.8,26
1740,2001,67.8,2005,66.8,4
1740,2009,68.6,2013,68.2,4
1740,2015,72.4,2017,72.4,2
1741,1899,100,2001,52.1,102
1741,2001,52.1,2005,46,4
1741,2005,46,2009,43.6,4
1741,2009,43.6,2013,42.5,4
1741,2014,54.9,2015,54.9,1
1741,2015,54.9,2016,54.5,1
1741,2016,54.5,2017,54.5,1
1742,1899,100,2001,54.8,102
1742,2001,54.8,2005,40.8,4
1742,2005,40.8,2009,38.3,4
1742,2009,38.3,2013,37.8,4
1743,2001,59.7,2005,54.5,4
1743,2011,95.6,2013,92.1,2
1743,2013,92.1,2015,89,2
1743,2015,89,2017,84,2
1744,1899,100,2001,61,102
1744,2001,61,2005,54.2,4
1744,2005,54.2,2009,53.2,4
1744,2013,64.1,2015,64.1,2
1744,2015,64.1,2017,64,2
1745,1899,100,2001,54.3,102
1745,2001,54.3,2005,50,4
1745,2005,50,2007,49.7,2
1745,2011,51,2013,47.6,2
1745,2015,50.7,2017,48,2
1746,1899,100,2001,49.1,102
1746,2009,70.1,2011,70.1,2
1746,2011,70.1,2013,67.4,2
1746,2013,67.4,2015,66.2,2
1747,1899,100,2001,53.8,102
1747,2001,53.8,2005,50.6,4
1747,2009,68.4,2011,66.6,2
1747,2011,66.6,2015,65.3,4
1747,2015,65.3,2017,64,2
1748,1899,100,2001,59.7,102
1748,2007,66.4,2009,64.8,2
1748,2009,64.8,2011,63.9,2
1748,2011,63.9,2013,63.4,2
1748,2013,63.4,2015,63.4,2
1748,2015,63.4,2017,63.4,2
1749,1899,100,2001,63.7,102
1749,2001,63.7,2005,52.1,4
1749,2007,64.2,2009,63.1,2
1749,2011,64.2,2013,64.1,2
1749,2013,64.1,2015,64.1,2
1749,2015,64.1,2017,49.6,2
1750,1899,100,2001,62.5,102
1750,2001,62.5,2005,41.3,4
1750,2005,41.3,2009,40.8,4
1750,2013,41.3,2015,40.8,2
1750,2015,40.8,2017,40.8,2
1751,2005,50.8,2009,26.4,4
1751,2013,26.6,2015,26.6,2
1752,1899,100,2001,36.1,102
1752,2009,55.1,2013,55.1,4
1752,2013,55.1,2015,55.1,2
1753,1979,100,2001,47.6,22
1753,2001,47.6,2005,46.1,4
1753,2015,60.1,2017,60.1,2
1754,1899,100,2001,51.6,102
1754,2001,51.6,2004,51.6,3
1754,2004,51.6,2005,49.9,1
1754,2011,71.6,2013,65.2,2
1754,2013,65.2,2015,58.5,2
1755,1899,100,2001,52.1,102
1755,2009,71,2011,70.7,2
1755,2011,70.7,2013,67.2,2
1755,2013,67.2,2015,65.6,2
1756,1899,100,2001,39.5,102
1756,2011,60.7,2013,60.6,2
1756,2013,60.6,2015,56.3,2
1756,2015,56.3,2017,56.3,2
1757,1899,100,2001,33.2,102
1757,2001,33.2,2005,30.9,4
1757,2007,66.8,2009,61.3,2
1757,2011,61.7,2013,60.6,2
1757,2013,60.6,2015,60.6,2
1757,2015,60.6,2017,60.5,2
1758,1899,100,2001,60.8,102
1758,2001,60.8,2005,56,4
1758,2009,74.5,2013,74.3,4
1759,1899,100,2001,69.3,102
1759,2001,69.3,2005,52.1,4
1759,2005,52.1,2009,49.1,4
1759,2013,54.8,2015,51.8,2
1759,2015,51.8,2017,46.2,2
1760,1899,100,2001,64.2,102
1760,2001,64.2,2005,63.7,4
1760,2005,63.7,2007,37.6,2
1760,2009,62.4,2011,58.2,2
1760,2013,62.4,2015,57.6,2
1760,2015,57.6,2017,57.6,2
1761,2007,83.9,2009,74.5,2
1761,2011,91.9,2013,86.2,2
1761,2013,86.2,2015,85.1,2
1761,2015,85.1,2017,58.3,2
1762,2012,100,2016,93.3,4
1763,1986,100,2003,90.7,17
1763,2006,92.4,2008,90.2,2
1763,2008,90.2,2010,87.5,2
1763,2012,88.8,2014,86.9,2
1763,2014,86.9,2016,84.8,2
1764,1963,100,2003,48.2,40
1764,2004,67.2,2006,64.3,2
1764,2008,64.7,2010,64.3,2
1764,2012,66.7,2014,66.7,2
1765,1991,100,2003,99.4,12
1765,2003,99.4,2004,97.7,1
1765,2006,98.2,2008,84.3,2
1766,1988,100,2003,88.2,15
1766,2003,88.2,2004,86.8,1
1766,2004,86.8,2006,84.5,2
1766,2006,84.5,2008,83,2
1766,2008,83,2010,78.9,2
1766,2010,78.9,2012,76.4,2
1766,2012,76.4,2014,75.6,2
1766,2014,75.6,2016,73.9,2
1767,1957,100,2003,68.9,46
1767,2003,68.9,2004,68.7,1
1767,2006,71.9,2008,71.7,2
1767,2010,72.2,2014,72.2,4
1767,2014,72.2,2016,71.5,2
1768,1983,100,2003,71.4,20
1768,2003,71.4,2004,70.6,1
1768,2006,82.5,2008,81.8,2
1768,2008,81.8,2010,81.4,2
1768,2010,81.4,2012,76.8,2
1768,2012,76.8,2014,69.2,2
1768,2014,69.2,2016,67.6,2
1769,1964,100,2003,45,39
1769,2003,45,2004,36.7,1
1769,2006,51.7,2008,46.8,2
1769,2010,47.8,2012,47.4,2
1769,2012,47.4,2014,47.2,2
1769,2014,47.2,2016,47.2,2
1770,2003,68.4,2004,62.4,1
1770,2006,68.8,2008,68.6,2
1770,2010,98.4,2012,97,2
1770,2012,97,2014,95.5,2
1770,2014,95.5,2016,88.2,2
1771,1969,100,2003,64.1,34
1771,2003,64.1,2004,64,1
1771,2006,68.7,2008,65.3,2
1771,2014,72.7,2016,71.2,2
1772,1965,100,2003,65.7,38
1772,2003,65.7,2004,64.4,1
1772,2006,71.9,2008,63.5,2
1772,2010,64.6,2012,63.9,2
1772,2012,63.9,2014,61,2
1773,1969,100,2003,92.9,34
1773,2003,92.9,2004,73.5,1
1773,2004,73.5,2006,53.5,2
1773,2006,53.5,2008,52,2
1773,2010,52.3,2012,47.4,2
1773,2012,47.4,2014,47.1,2
1773,2014,47.1,2016,46.9,2
1774,1966,100,2003,74.9,37
1774,2003,74.9,2004,74.1,1
1774,2004,74.1,2006,73.2,2
1774,2006,73.2,2008,71.9,2
1774,2008,71.9,2010,71.8,2
1774,2010,71.8,2012,70.5,2
1774,2012,70.5,2014,70.1,2
1774,2014,70.1,2016,69,2
1775,1986,100,2003,75,17
1775,2003,75,2004,74.7,1
1775,2006,85.4,2008,85.4,2
1775,2008,85.4,2010,84.6,2
1775,2010,84.6,2012,79.7,2
1775,2012,79.7,2014,74.9,2
1775,2014,74.9,2016,70.9,2
1776,1976,100,2003,74.4,27
1776,2003,74.4,2004,74.4,1
1776,2004,74.4,2006,69.8,2
1776,2006,69.8,2008,69.5,2
1776,2008,69.5,2010,68.3,2
1776,2010,68.3,2012,66.6,2
1776,2012,66.6,2014,66.3,2
1777,1998,100,2003,88.2,5
1777,2003,88.2,2004,88,1
1777,2006,91.2,2008,90.6,2
1777,2008,90.6,2010,86,2
1778,1966,100,2003,66.4,37
1778,2003,66.4,2004,66.4,1
1778,2006,70.5,2008,68.4,2
1778,2008,68.4,2010,68.4,2
1778,2012,69.4,2014,67.9,2
1779,1985,100,2003,95.1,18
1779,2003,95.1,2004,91.6,1
1779,2004,91.6,2006,72.2,2
1779,2008,72.3,2010,72.2,2
1779,2010,72.2,2012,72.1,2
1779,2012,72.1,2014,71.9,2
1779,2014,71.9,2016,71.7,2
1780,1969,100,2003,74.6,34
1780,2003,74.6,2004,73.1,1
1780,2004,73.1,2006,60.6,2
1780,2006,60.6,2008,54.6,2
1780,2008,54.6,2010,51.3,2
1780,2010,51.3,2012,46.5,2
1780,2012,46.5,2014,41.8,2
1781,1969,100,2003,75,34
1781,2003,75,2004,73.7,1
1781,2004,73.7,2006,71.8,2
1781,2006,71.8,2008,71.8,2
1781,2008,71.8,2010,70,2
1781,2010,70,2012,70,2
1781,2012,70,2014,69.6,2
1781,2014,69.6,2016,69.5,2
1782,2003,58.2,2004,58.2,1
1782,2006,60.1,2008,48,2
1782,2010,97.7,2014,97.6,4
1783,2003,67.8,2004,66.5,1
1783,2004,66.5,2006,30.1,2
1783,2006,30.1,2008,22.3,2
1783,2008,22.3,2010,20.8,2
1783,2010,20.8,2012,18,2
1783,2012,18,2014,17.6,2
1784,1964,100,2003,73.5,39
1784,2003,73.5,2004,73.5,1
1784,2004,73.5,2006,71.8,2
1784,2006,71.8,2008,71,2
1784,2010,71.1,2014,70.9,4
1785,1964,100,2003,56.7,39
1785,2003,56.7,2004,56.7,1
1785,2006,62.3,2008,52.4,2
1785,2008,52.4,2010,52.4,2
1785,2010,52.4,2012,48.6,2
1785,2012,48.6,2014,48.4,2
1786,1964,100,2003,64.3,39
1786,2008,67.5,2010,66.7,2
1786,2010,66.7,2012,65.5,2
1786,2012,65.5,2014,63.7,2
1786,2014,63.7,2016,63.7,2
1787,2003,75,2004,70.8,1
1787,2004,70.8,2006,69.2,2
1787,2010,69.7,2012,66.1,2
1787,2012,66.1,2014,63.4,2
1788,2003,66.2,2004,62.6,1
1788,2004,62.6,2006,59.7,2
1788,2010,60.4,2012,58,2
1788,2012,58,2014,56.9,2
1789,1964,100,2003,75,39
1789,2003,75,2004,67.3,1
1789,2008,74.9,2010,74.9,2
1789,2010,74.9,2014,74.9,4
1789,2014,74.9,2016,74.9,2
1790,1969,100,2008,68.2,39
1790,2008,68.2,2010,68.2,2
1790,2012,72.2,2014,71.4,2
1790,2014,71.4,2016,70.2,2
1791,1985,100,2008,73.1,23
1791,2008,73.1,2010,73.1,2
1791,2010,73.1,2012,72.4,2
1791,2012,72.4,2014,72.4,2
1791,2014,72.4,2016,72.3,2